"a" = (/turf/closed/indestructible/concept,/area/awaymission/conceptual)
"d" = (/turf/closed/indestructible/riveted/hierophant,/area/awaymission/conceptual)
"f" = (/obj/effect/light_emitter{set_cap = 3; set_luminosity = 5},/turf/open/indestructible/hierophant/concept/two,/area/awaymission/conceptual)
"i" = (/obj/machinery/telecomms/relay/preset/auto,/turf/open/indestructible/concept,/area/awaymission/conceptual)
"m" = (/obj/machinery/door/airlock/public/glass,/turf/open/indestructible/concept,/area/awaymission/conceptual)
"o" = (/obj/structure/elite_tumor/threat,/turf/open/indestructible/hierophant/concept/two,/area/awaymission/conceptual)
"u" = (/turf/open/indestructible/hierophant/concept/two,/area/awaymission/conceptual)
"B" = (/turf/open/indestructible/concept,/area/awaymission/conceptual)
"F" = (/mob/living/basic/cow,/turf/open/indestructible/concept,/area/awaymission/conceptual)
"H" = (/turf/open/indestructible/hierophant/concept,/area/awaymission/conceptual)
"N" = (/obj/machinery/gateway/away,/turf/open/indestructible/concept,/area/awaymission/conceptual)
"R" = (/mob/living/simple_animal/hostile/concept,/turf/open/indestructible/concept,/area/awaymission/conceptual)
"Z" = (/obj/effect/light_emitter{set_cap = 3; set_luminosity = 5},/turf/open/indestructible/hierophant/concept,/area/awaymission/conceptual)

(1,1,1) = {"
aaaaaaaaaaaaaaaaaaaaaaaaaaaaaaaaaaaaaaaaaaaaaaaaaaaaaaaaaaaaaaaaaaaaaaaaaaaaaaaaaaaaaaaaaaaaaaaaaaaa
aBBBiaBBBBBBBBBBBBBBBBBBBBBBBBBBBBBBBBBBBBBBBBBBBBBBBBBBBBBBBBBBBBBBBBBBBBBBBBBBBBBBBBBBBBBBBBBBBBBa
aBNBBaBBBBBBBBBBBBBBBBBBBBBBBBBBBBBBBBBBBBBBBBBBBBBBBBBBBBBBBBBBBBBBBBBBBBBBBBBBBBBBBBBBBBBBBBBBBBBa
aBBBBaBBBBBBBBBBBBBBBBBBBBBBBBBBBBBBBBBBBBBBBBBBBBBBBBBBBBBBBBBBBBBBBBBBBBBBBBBBBBBBBBBBBBBBBBBBBBBa
aBBBBaBBBBBBBBBBBBBBBBBBBBBBBBBBBBBBBBBBBBBBBBBBBBBBBBBBBBBBBBBBBBBBBBBBBBBBBBBBBBBBBBBBBBBBBBBBBBBa
aBBBFaBBBBBBBBBBBBBBBBBBBBBBBBBBBBBBBBBBBBBBBBBBBBBBBBBBBBBBBBBBBBBBBBBBBBBBBBBBBBBBBBBBBBBBBBBBBBBa
aamaaaBBBBBBBBBBBBBBBBBBBBBBBBBBBBBBBBBBBBBBBBBBBBBBBBBBBBBBBBBBBBBBBBBBBBBBBBBBBBBBBBBBBBBBBBBBBBBa
aBBBBBBBBBBBBBBBBBBBBBBBBBBBBBBBBBBBBBBBBBBBBBBBBBBBBBBBBBBBBBBBBBBBBBBBBBBBBBBBBBBBBBBBBBBBBBBBBBBa
aBBBBBBBBBBBBBBBBBBBBBBBBBBBBBBBBBBBBBBBBBBBBBBBBBBBBBBBBBBBBBBBBBBBBBBBBBBBBBBBBBBBBBBBBBBBBBBBBBBa
aBBBBBBBBBBBBBBBBBBBBBBBBBBBBBBBBBBBBBBBBBBBBBBBBBBBBBBBBBBBBBBBBBBBBBBBBBBBBBBBBBBBBBBBBBBBBBBBBBBa
aBBBBBBBBBBBBBBBBBBBBBBBBBBBBBBBBBBBBBBBBBBBBBBBBBBBBBBBBBBBBBBBBBBBBBBBBBBBBBBBBBBBBBBBBBBBBBBBBBBa
aBBBBBBBBBBBBBBBBBBBBBBBBBBBBBBBBBBBBBBBBBBBBBBBBBBBBBBBBBBBBBBBBBBBBBBBBBBBBBBBBBBBBBBBBBBBBBBBBBBa
aBBBBBBBBBBBBBBBBBBBBBBBBBBBBBBBBBBBBBBBBBBBBBBBBBBBBBBBBBBBBBBBBBBBBBBBBBBBBBBBBBBBBBBBBBBBBBBBBBBa
aBBBBBBBBBBBBBBBBBBBBBBBBBBBBBBBBBBBBBBBBBBBBBBBBBBBBBBBBBBBBBBBBBBBBBBBBBBBBBBBBBBBBBBBBBBBBBBBBBBa
aBBBBBBBBBBBBBBBBBBBBBBBBBBBBBBBBBBBBBBBBBBBBBBBBBBBBBBBBBBBBBBBBBBBBBBBBBBBBBBBBBBBBBBBBBBBBBBBBBBa
aBBBBBBBBBBBBBBBBBBBBBBBBBBBBBBBBBBBBBBBBBBBBBBBBBBBBBBBBBBBBBBBBBBBBBBBBBBBBBBBBBBBBBBBBBBBBBBBBBBa
aBBBBBBBBBBBBBBBBBBBBBBBBBBBBBBBBBBBBBBBBBBBBBBBBBBBBBBBBBBBBBBBBBBBBBBBBBBBBBBBBBBBBBBBBBBBBBBBBBBa
aBBBBBBBBBBBBBBBBBBBBBBBBBBBBBBBBBBBBBBBBBBBBBBBBBBBBBBBBBBBBBBBBBBBBBBBBBBBBBBBBBBBBBBBBBBBBBBBBBBa
aBBBBBBBBBBBBBBBBBBBBBBBBBBBBBBBBBBBBBBBBBBBBBBBBBBBBBBBBBBBBBBBBBBBBBBBBBBBBBBBBBBBBBBBBBBBBBBBBBBa
aBBBBBBBBBBBBBBBBBBBBBBBBBBBBBBBBBBBBBBBBBBBBBBBBBBBBBBBBBBBBBBBBBBBBBBBBBBBBBBBBBBBBBBBBBBBBBBBBBBa
aBBBBBBBBBBBBBBBBBBBBBBBBBBBBBBBBRBRBBBBBBBBBBBBBBBBBBBBBBBBBBBBBBBBBBBBBBBBBBBBBBBBBBBBBBBBBBBBBBBa
aBBBBBBBBBBBBBBBBBBBBBBBBBBBBBBBBBRBBBBBBBBBBBBBBBBBBBBBBBBBBBBBBBBBBBBBBBBBBBBBBBBBBBBBBBBBBBBBBBBa
aBBBBBBBBBBBBBBBBBBBBBBBBBBBBBBBBRBRBBBBBBBBBBBBBBBBBBBBBBBBBBBBBBBBBBBBBBBBBBBBBBBBBBBBBBBBBBBBBBBa
aBBBBBBBBBBBBBBBBRBRBBBBBBBBBBBBBBBBBBBBBBBBBBBBBBBBBBBBBBBBBBBBBBBBBBBBBBBBBBBBBBBBBBBBBBBBBBBBBBBa
aBBBBBBBBBBBBBBBBBRBBBBBBBBBBBBBBBBBBBBBBBBBBBBBBBBBBBBBBBBBBBBBBBBBBBBBRBRBBBBBBBBBBBBBBBBBBBBBBBBa
aBBBBBBBBBBBBBBBBRBRBBBBBBBBBBBBBBBBBBBBBBBBBBBBBBBBBBBBBBBBBBBBBBBBBBBBBRBBBBBBBBBBBBBBBBBBBBBBBBBa
aBBBBBBBBBBBBBBBBBBBBBBBBBBBBBBBBBBBBBBBBBBBBBBBBBBBBBBBBBBBBBBBBBBBBBBBRBRBBBBBBBBBBBBBBBBBBBBBBBBa
aBBBBBBBBBBBBBBBBBBBBBBBBBBBBBBBBBBBBBBBBBBBBBBBBBBBBBBBBBBBBBBBBBBBBBBBBBBBBBBBBBBBBBBBBBBBBBBBBBBa
aBBBBBBBBBBBBBBBBBBBBBBBBBBBBBBBBBBBBBBBBBBBBBBBBBBBBBBBBBBBBBBBBBBBBBBBBBBBBBBBBBBBBBBBBBBBBBBBBBBa
aBBBBBBBBBBBBBBBBBBBBBBBBBBBBBBBBBBBBBBBBBBBBBBBBBBBBBBBBBBBBBBBBBBBBBBBBBBBBBBBBBBBBBBBBBBBBBBBBBBa
aBBBBBBBBBBBBBBBBBBBBBBBBBRBRBBBBBBBBBBBBBBBBBBBBBBBBBBBBBBBBBBBBBBBBBBBBBBBBBBBBBBBBBBBBBBBBBBBBBBa
aBBBBBBBBBBBBBBBBBBBBBBBBBBRBBBBBBBBBBBBBBBBBBBBBBBBBBBBBBBBBBBBBBBBBBBBBBBBBBBBBBBBBBBBBBBBBBBBBBBa
aBBBBBBBBBBBBBBBBBBBBBBBBBRBRBBBBBBBBBBBBBBBBBBBBBBBBBBBBBBBBBBBBBBBBBBBBBBBBBBBBBBBBBBBBBBBBBBBBBBa
aBBBBBBBBBBBBBBBBBBBBBBBBBBBBBBBBBBBBBBBBBBBBBBBBBBBBBBBBBBBBBBBBBBBBBBBBBBBBBBBBBBBBBBBBBBBBBBBBBBa
aBBBBBBBBBBBBBBBBBBBBBBBBBBBBBBBBBBBBBBBBBBBBBBBBBBBBBBBBBBBBBBBBBBBBBBBBBBBBBBBBBBBBBBBBBBBBBBBBBBa
aBBBBBBBBBBBBBBBBBBBBBBBBBBBBBBBBBRBRBBBBBBBBBBBBBBBBBBBBBBBBBBBBBBBBBBBBBBBBBBBBBBBBBBBBBBBBBBBBBBa
aBBBBBBBBBBBBBBBBBBBBBBBBBBBBBBBBBBRBBBBBBBBBBBBBBBBBBBBBBBBBBBBBBBBBBBBBBBBBBBBBBBBBBBBBBBBBBBBBBBa
aBBBBBBBBBBBBBBBBBBBBBBBBBBBBBBBBBRBRBBBBBBBBBBBBBBBBBBBBBBBBBBBBBBBBBBBBBBBBBBBBBBBBBBBBBBBBBBBBBBa
aBBBBBBBBBBBBBBBBBBBBBBBBBBBBBBBBBBBBBBBBBBBBBBBBBBBBBBBBBBBBBBBBBBBBBBBBBBBBBBBBBBBBBBBBBBBBBBBBBBa
aBBBBBBBBBBBBBBBBBBBBBBBBBBBBBBBBBBBBBBBBBBBBBBBBBBBBBBBBBBBBBBBBBBBBBBBBBBBBBBBBBBBBBBBBBBBBBBBBBBa
aBBBBBBBBBBBBBBBBBBBBBBBBBBBBBBBBBBBBBdddHHHHdddddddddHHHHdddBBBBBBBBBBBBBBBBBBBBBBBBBBBBBBBBBBBBBBa
aBBBBBBBBBBBBBBBBBBBBBBBBBBBBBBBBBBBBBdHHHHHHHHHHZHHHHHHHHHHdBBBBBBBBBBBBBBBBBBBBBBBBBBBBBBBBBBBBBBa
aBBBBBBBBBBBBBBBBBBBBBBBBBBBBBBBBBBBBBdHHHZZHHHdHHHdHHHZZHHHdBBBBBBBBBBBBBBBBBBBBBBBBBBBBBBBBBBBBBBa
aBBBBBBBBBBBBBBBBBBBBBBBBBBBBBBBBBBBBBHHHHHHHHHHHHHHHHHHHHHHHBBBBBBBBBBBBBBBBBBBBBBBBBBBBBBBBBBBBBBa
aBBBBBBBBBBBBBBBBBBBBBBBBBBBBBBBBBBBBBHHZHddHZHHHZHHHZHddHZHHBBBBBBBBBBBBBBBBBBBBBBBBBBBBBBBBBBBBBBa
aBBBBBBBBBBBBBBBBBBBBBBBBBBBBBBBBBBBBBHHZHddHZHHHZHHHZHddHZHHBBBBBBBBBBBBBBBBBBBBBBBBBBBBBBBBBBBBBBa
aBBBBBBBBBBBBBBRBRBBBBBBBBBBBBBBBBBBBBHHHHHHuuuuuuuuuuuHHHHHHBBBBBBBBBBBBBBBBBBBBBBBBBBBBBBBBBBBBBBa
aBBBBBBBBBBBBBBBRBBBBBBBBBBBBBBBBBBBBBdHHHZZuuuduuuduuuZZHHHdBBBBBBBBBBBBBBBBBBBBBBBBBBBBBBBBBBBBBBa
aBBBBBBBBBBBBBBRBRBBBBBBBBBBBBBBBBBBBBdHHHHHuuuuufuuuuuHHHHHdBBBBBBBBBBBBBBBBBBBBBBBBBBBBBBBBBBBBBBa
aBBBBBBBBBBBBBBBBBBBBBBBBBBBBBBBBBBBBBdHdHHHuduuuuuuuduHHHdHdBBBBBBBBBBBBBBBBRBRBBBBBBBBBBBBBBBBBBBa
aBBBBBBBBBBBBBBBBBBBBBBBBBBBBBBBBBBBBBdHHHHHuuuuuuuuuuuHHHHHdBBBBBBBBBBBBBBBBBRBBBBBBBBBBBBBBBBBBBBa
aBBBBBBBBBBBBBBBBBBBBBBBBBBBBBBBBBBBBBdZHHZZuufuuouufuuZZHHZdBBBBBBBBBBBBBBBBRBRBBBBBBBBBBBBBBBBBBBa
aBBBBBBBBBBBBBBBBBBBBBBBBBBBBBBBBBBBBBdHHHHHuuuuuuuuuuuHHHHHdBBBBBBBBBBBBBBBBBBBBBBBBBBBBBBBBBBBBBBa
aBBBBBBBBBBBBBBBBBBBBBBBBBBBBBBBBBBBBBdHdHHHuduuuuuuuduHHHdHdBBBBBBBBBBBBBBBBBBBBBBBBBBBBBBBBBBBBBBa
aBBBBBBBBBBBBBBBBBBBBBBBBBBBBBBBBBBBBBdHHHHHuuuuufuuuuuHHHHHdBBBBBBBBBBBBBBBBBBBBBBBBBBBBBBBBBBBBBBa
aBBBBBBBBBBBBBBBBBBBBBBBBBBBBBBBBBBBBBdHHHZZuuuduuuduuuZZHHHdBBBBBBBBBBBBBBBBBBBBBBBBBBBBBBBBBBBBBBa
aBBBBBBBBBBBBBBBBBBBBBBBBBBBBBBBBBBBBBHHHHHHuuuuuuuuuuuHHHHHHBBBBBBBBBBBBBBBBBBBBBBBBBBBBBBBBBBBBBBa
aBBBBBBBBBBBBBBBBBBBBBBBBBBBBBBBBBBBBBHHZHddHZHHHZHHHZHddHZHHBBBBBBBBBBBBBBBBBBBBBBBBBBBBBBBBBBBBBBa
aBBBBBBBBBBBBBBBBBBBBBBBBBBBBBBBBBBBBBHHZHddHZHHHZHHHZHddHZHHBBBBBBBBBBBBBBBBBBBBBBBBBBBBBBBBBBBBBBa
aBBBBBBBBBBBBBBBBBBBBBBBBBBBBBBBBBBBBBHHHHHHHHHHHHHHHHHHHHHHHBBBBBBBBBBBBBBBBBBBBBBBBBBBBBBBBBBBBBBa
aBBBBBBBBBBBBBBBBBBBBBBBBBBBBBBBBBBBBBdHHHZZHHHdHHHdHHHZZHHHdBBBBBBBBBBBBBBBBBBBBBBBBBBBBBBBBBBBBBBa
aBBBBBBBBBBBBBBBBBBBBBBBBBBBBBBBBBBBBBdHHHHHHHHHHZHHHHHHHHHHdBBBBBBBBBBBBBBBBBBBBBBBBBBBBBBBBBBBBBBa
aBBBBBBBBBBBBBBBBBBBBBBBBBBBBBBBBBBBBBdddHHHHdddddddddHHHHdddBBBBBBBBBBBBBBBBBBBBBBBBBBBBBBBBBBBBBBa
aBBBBBBBBBBBBBBBBBBBBBBBBBBBBBBBBBBBBBBBBBBBBBBBBBBBBBBBBBBBBBBBBBBBBBBBBBBBBBBBBBBBBBBBBBBBBBBBBBBa
aBBBBBBBBBBBBBBBBBBBBBBBBBBBBBBBBBBBBBBBBBBBBBBBBBBBBBBBBBBBBBBBBBBBBBBBBBBBBBBBBBBBBBBBBBBBBBBBBBBa
aBBBBBBBBBBBBBBBBBBBBBBBBBBBBBBBBBBBBBBBBBBBBBBBBBBBBBBBBBBBBBBBBBBBBBBBBBBBBBBBBBBBBBBBBBBBBBBBBBBa
aBBBBBBBBBBBBBBBBBBBBBBBBBBBBBBBBBBBBBBBBBBBBBBBBBBBBBBBBBBBBBBBBBBBBBBBBBBBBBBBBBBBBBBBBBBBBBBBBBBa
aBBBBBBBBBBBBBBBBBBBBBBBBBBBBBBBBBBBBBBBBBBBBBBBBBBBBBBBBBBBBBBBBBBBBBBBBBBBBBBBBBBBBBBBBBBBBBBBBBBa
aBBBBBBBBBBBBBBBBBBBBBBBBBBBBBBBBBBBBBBBBBBBBBBBBBBBBBBBBBBBBBBBBBBBBBBBBBBBBBBBBBBBBBBBBBBBBBBBBBBa
aBBBBBBBBBBBBBBBBBBBBBBBBBBBBBBBBBBBBBBBBBBBBBBBBBBBBBBBBBBBBBBBBBBBBBBBBBBBBBBBBRBRBBBBBBBBBBBBBBBa
aBBBBBBBBBBBBBBBBBBBBBBBBBBBBBBBBBBBBBBBBBBBBBBBBBBBBBBBBBBBBBBBBBBBBBBBBBBBBBBBBBRBBBBBBBBBBBBBBBBa
aBBBBBBBBBBBBBBBBBBBBBBBBBBBBBBBBBBBBBBBBBBBBBBBBBBBBBBBBBBBBBBBBBBBBBBBBBBBBBBBBRBRBBBBBBBBBBBBBBBa
aBBBBBBBBBBBBBBBBBBBBBBBBBBBBBBBBBBBBBBBBBBBBBBBBBBBBBBBBBBBBBBBBBBBBBBBBBBBBBBBBBBBBBBBBBBBBBBBBBBa
aBBBBBBBBBBBBBBBBBBBBBBBBBBBBBBBBBBBBBBBBBBBBBBBBBBBBBBBBBBBBBBBBBBBBBBBBBBBBBBBBBBBBBBBBBBBBBBBBBBa
aBBBBBBBBBBBBBBBBBBBBBBBBBBBBBBBBBBBBBBBBBBBBBBBBBBBBBBBBBBBBBBBBBBBBBBBBBBBBBBBBBBBBBBBBBBBBBBBBBBa
aBBBBBBBBBBBBBBBBBBBBBBBBBBBBBBBBBBBBBBBBBBBBBBBBBBBBBBBBBBBBBBBBBBBBBBBBBBBBBBBBBBBBBBBBBBBBBBBBBBa
aBBBBBBBBBBBBBBBBBBBBBBBBBBBBBBBBBBBBBBBBBBBBBBBBBBBBBBBBBBBBBBBBBBBBBBBBBBBBBBBBBBBBBBBBBBBBBBBBBBa
aBBBBBBBBBBBBBBBRBRBBBBBBBBBBBBBBBBBBBBBRBRBBBBBBBBBBBBBBBBBBBBBBBBBBBBBBBBBBBBBBBBBBBBBBBBBBBBBBBBa
aBBBBBBBBBBBBBBBBRBBBBBBBBBBBBBBBBBBBBBBBRBBBBBBBBBBBBBBBBBBBBBBBBBBBBBBBBBBBBBBBBBBBBBBBBBBBBBBBBBa
aBBBBBBBBBBBBBBBRBRBBBBBBBBBBBBBBBBBBBBBRBRBBBBBBBBBBBBBBBBBBBBBBBBBBBBBBBBBBBBBBBBBBBBBBBBBBBBBBBBa
aBBBBBBBBBBBBBBBBBBBBBBBBBBBBBBBBBBBBBBBBBBBBBBBBBBBBBBBBBBBBBBBBBBBBBBBBBBBBBBBBBBBBBBBBBBBBBBBBBBa
aBBBBBBBBBBBBBBBBBBBBBBBBBBBBBBBBBBBBBBBBBBBBBBBBBBBBBBBBBBBBBBBBBBBBBBBBBBBBBBBBBBBBBBBBBBBBBBBBBBa
aBBBBBBBBBBBBBBBBBBBBBBBBBBBBBBBBBBBBBBBBBBBBBBBBBBBBBBBBBBBBBBBBBBBBBBBBBBBBBBBBBBBBBBBBBBBBBBBBBBa
aBBBBBBBBBBBBBBBBBBBBBBBBBBBBBBBBBBBBBBBBBBBBBBBBBBBBBBBBBBBBBBBBBBBBBBBBBBBBBBBBBBBBBBBBBBBBBBBBBBa
aBBBBBBBBBBBBBBBBBBBBBBBBBBBBBBBBBBBBBBBBBBBBBBBBBBBBBBBBBBBBBBBBBBBBBBBBBBBBBBBBBBBBBBBBBBBBBBBBBBa
aBBBBBBBBBBBBBBBBBBBBBBBBBBBBBBBBBBBBBBBBBBBBBBBBBBBBBBBBBBBBRBRBBBBBBBBBBBBBBBBBBBBBBBBBBBBBBBBBBBa
aBBBBBBBBBBBBBBBBBBBBBBBBBBBBBBBBBBBBBBBBBBBBBBBBBBBBBBBBBBBBBRBBBBBBBBBBBBBBBBBBBBBBBBBBBBBBBBBBBBa
aBBBBBBBBBBBBBBBBBBBBBBBBBBBBBBBBBBBBBBBBBBBBBBBBBBBBBBBBBBBBRBRBBBBBBBBBBBBBBBBBBBBBBBBBBBBBBBBBBBa
aBBBBBBBBBBBBBBBBBBBBBBBBBBBBBBBBBBBBBBBBBBBBBBBBBBBBBBBBBBBBBBBBBBBBBBBBBBBBBBBBBBBBBBBBBBBBBBBBBBa
aBBBBBBBBBBBBBBBBBBBBBBBBBBBBBBBBBBBBBBBBBBBBBBBBBBBBBBBBBBBBBBBBBBBBBBBBBBBBBBBBBBBBBBBBBBBBBBBBBBa
aBBBBBBBBBBBBBBBBBBBBBBBBBBBBBBBBBBBBBBBBBBBBBBBBBBBBBBBBBBBBBBBBBBBBBBBBBBBBBBBBBBBBBBBBBBBBBBBBBBa
aBBBBBBBBBBBBBBBBBBBBBBBBBBBBBBBBBBBBBBBBBBBBBBBBBBBBBBBBBBBBBBBBBBBBBBBBBBBBBBBBBBBBBBBBBBBBBBBBBBa
aBBBBBBBBBBBBBBBBBBBBBBBBBBBBBBBBBBBBBBBBBBBBBBBBBBBBBBBBBBBBBBBBBBBBBBBBBBBBBBBBBBBBBBBBBBBBBBBBBBa
aBBBBBBBBBBBBBBBBBBBBBBBBBBBBBBBBBBBBBBBBBBBBBBBBBBBBBBBBBBBBBBBBBBBBBBBBBBBBBBBBBBBBBBBBBBBBBBBBBBa
aBBBBBBBBBBBBBBBBBBBBBBBBBBBBBBBBBBBBBBBBBBBBBBBBBBBBBBBBBBBBBBBBBBBBBBBBBBBBBBBBBBBBBBBBBBBBBBBBBBa
aBBBBBBBBBBBBBBBBBBBBBBBBBBBBBBBBBBBBBBBBBBBBBBBBBBBBBBBBBBBBBBBBBBBBBBBBBBBBBBBBBBBBBBBBBBBBBBBBBBa
aBBBBBBBBBBBBBBBBBBBBBBBBBBBBBBBBBBBBBBBBBBBBBBBBBBBBBBBBBBBBBBBBBBBBBBBBBBBBBBBBBBBBBBBBBBBBBBBBBBa
aBBBBBBBBBBBBBBBBBBBBBBBBBBBBBBBBBBBBBBBBBBBBBBBBBBBBBBBBBBBBBBBBBBBBBBBBBBBBBBBBBBBBBBBBBBBBBBBBBBa
aBBBBBBBBBBBBBBBBBBBBBBBBBBBBBBBBBBBBBBBBBBBBBBBBBBBBBBBBBBBBBBBBBBBBBBBBBBBBBBBBBBBBBBBBBBBBBBBBBBa
aaaaaaaaaaaaaaaaaaaaaaaaaaaaaaaaaaaaaaaaaaaaaaaaaaaaaaaaaaaaaaaaaaaaaaaaaaaaaaaaaaaaaaaaaaaaaaaaaaaa
"}
