//MAP CONVERTED BY dmm2tgm.py THIS HEADER COMMENT PREVENTS RECONVERSION, DO NOT REMOVE
"a" = (
/turf/open/floor/iron/terracotta{
	initial_gas_mix = "o2=22;n2=82;TEMP=318.15"
	},
/area/ruin/unpowered)
"b" = (
/turf/template_noop,
/area/template_noop)
"d" = (
/obj/structure/closet/crate/coffin{
	anchored = 1
	},
/obj/effect/mob_spawn/corpse/human/skeleton/mummy,
/obj/item/instrument/trombone,
/turf/open/floor/iron/terracotta/small,
/area/ruin/unpowered)
"e" = (
/obj/structure/flora/bush/sparsegrass/style_random,
/turf/open/misc/beach/sand,
/area/icemoon/underground/unexplored)
"g" = (
/obj/structure/closet/crate/coffin{
	anchored = 1
	},
/obj/effect/mob_spawn/corpse/human/skeleton/mummy,
/obj/item/spear/bonespear,
/turf/open/floor/iron/terracotta/small,
/area/ruin/unpowered)
"h" = (
/obj/structure/flora/rock/style_random,
/turf/open/misc/sandy_dirt{
	initial_gas_mix = "o2=22;n2=82;TEMP=318.15"
	},
/area/ruin/unpowered)
"i" = (
/obj/structure/closet/crate/coffin{
	anchored = 1
	},
/obj/effect/mob_spawn/corpse/human/skeleton,
/obj/effect/decal/cleanable/dirt/dust,
/obj/item/fishing_rod/bone,
/obj/item/fishing_hook/bone,
/turf/open/floor/iron/terracotta/small,
/area/ruin/unpowered)
"j" = (
/obj/structure/mineral_door/sandstone,
/obj/effect/turf_decal/weather/sand{
	dir = 4
	},
/turf/open/floor/iron/terracotta{
	initial_gas_mix = "o2=22;n2=82;TEMP=318.15"
	},
/area/ruin/unpowered)
"k" = (
/obj/structure/flora/rock/style_random,
/turf/open/misc/beach/sand,
/area/icemoon/underground/unexplored)
"l" = (
/obj/structure/closet/crate/coffin{
	anchored = 1
	},
/obj/effect/mob_spawn/corpse/human/skeleton,
/obj/effect/decal/cleanable/dirt/dust,
/obj/item/spear/bonespear,
/turf/open/floor/iron/terracotta{
	initial_gas_mix = "o2=22;n2=82;TEMP=318.15"
	},
/area/ruin/unpowered)
"o" = (
/turf/closed/mineral/sand,
/area/icemoon/underground/unexplored)
"p" = (
/obj/structure/closet/crate/coffin{
	anchored = 1
	},
/obj/effect/mob_spawn/corpse/human/skeleton,
/obj/item/stack/sheet/bone,
/turf/open/floor/iron/terracotta/small,
/area/ruin/unpowered)
"q" = (
/obj/effect/decal/cleanable/dirt/dust,
/obj/structure/flora/bush/sparsegrass/style_random,
/turf/open/misc/sandy_dirt{
	initial_gas_mix = "o2=22;n2=82;TEMP=318.15"
	},
/area/ruin/unpowered)
"s" = (
/obj/structure/closet/crate/coffin{
	anchored = 1
	},
/turf/open/floor/iron/terracotta/small,
/area/ruin/unpowered)
"t" = (
/obj/structure/flora/ash/cacti,
/turf/open/misc/beach/sand,
/area/icemoon/underground/unexplored)
"v" = (
/mob/living/basic/skeleton/mummy,
/turf/open/floor/iron/terracotta{
	initial_gas_mix = "o2=22;n2=82;TEMP=318.15"
	},
/area/ruin/unpowered)
"x" = (
/turf/open/misc/beach/sand,
/area/icemoon/underground/unexplored)
"z" = (
/turf/open/misc/sandy_dirt{
	initial_gas_mix = "o2=22;n2=82;TEMP=318.15"
	},
/area/ruin/unpowered)
"C" = (
/obj/structure/closet/crate/coffin{
	anchored = 1
	},
/obj/effect/decal/cleanable/dirt/dust,
/turf/open/floor/iron/terracotta/small,
/area/ruin/unpowered)
"E" = (
/obj/effect/decal/cleanable/dirt/dust,
/turf/open/misc/sandy_dirt{
	initial_gas_mix = "o2=22;n2=82;TEMP=318.15"
	},
/area/ruin/unpowered)
"H" = (
/obj/structure/flora/tree/palm/style_random,
/turf/open/misc/beach/sand,
/area/icemoon/underground/unexplored)
"I" = (
/obj/structure/closet/crate/coffin{
	anchored = 1
	},
/obj/effect/mob_spawn/corpse/human/skeleton/mummy,
/obj/effect/decal/cleanable/dirt/dust,
/obj/item/fireaxe/boneaxe,
/turf/open/floor/iron/terracotta/small,
/area/ruin/unpowered)
"J" = (
/obj/effect/decal/cleanable/dirt/dust,
/turf/open/floor/iron/terracotta{
	initial_gas_mix = "o2=22;n2=82;TEMP=318.15"
	},
/area/ruin/unpowered)
"K" = (
/obj/structure/closet/crate/coffin{
	anchored = 1
	},
/obj/effect/mob_spawn/corpse/human/skeleton/mummy,
/obj/effect/decal/cleanable/dirt/dust,
/turf/open/floor/iron/terracotta/small,
/area/ruin/unpowered)
"O" = (
/obj/structure/flora/bush/sparsegrass/style_random,
/turf/open/misc/sandy_dirt{
	initial_gas_mix = "o2=22;n2=82;TEMP=318.15"
	},
/area/ruin/unpowered)
"Q" = (
/obj/structure/closet/crate/coffin{
	anchored = 1
	},
/obj/effect/mob_spawn/corpse/human/skeleton,
/obj/effect/decal/cleanable/dirt/dust,
/obj/item/stack/sheet/bone,
/turf/open/floor/iron/terracotta/small,
/area/ruin/unpowered)
"R" = (
/turf/closed/wall/mineral/sandstone,
/area/ruin/unpowered)
"S" = (
/obj/item/book/granter/crafting_recipe/boneyard_notes{
	name = "Guide to Embalming";
	desc = "A guide on embalming mummies. Actually upon further inspection it's a guide on making weird stuff out of bones."
	},
/obj/structure/rack/skeletal{
	name = "rack"
	},
/turf/open/floor/iron/terracotta{
	initial_gas_mix = "o2=22;n2=82;TEMP=318.15"
	},
/area/ruin/unpowered)
"X" = (
/obj/effect/decal/cleanable/dirt/dust,
/turf/open/floor/iron/terracotta/small,
/area/ruin/unpowered)
"Y" = (
/obj/structure/mineral_door/sandstone,
/turf/open/floor/iron/terracotta{
	initial_gas_mix = "o2=22;n2=82;TEMP=318.15"
	},
/area/ruin/unpowered)

(1,1,1) = {"
b
b
b
b
b
b
b
b
b
b
b
b
b
b
b
b
b
b
b
"}
(2,1,1) = {"
b
b
R
R
R
R
R
R
R
R
R
R
R
R
z
z
R
b
b
"}
(3,1,1) = {"
b
R
R
a
J
J
a
z
z
R
S
Y
z
q
z
a
R
R
b
"}
(4,1,1) = {"
b
R
O
i
a
C
v
p
O
R
R
R
a
z
J
a
a
R
b
"}
(5,1,1) = {"
x
R
z
z
O
a
a
J
J
z
E
R
a
R
R
z
J
R
b
"}
(6,1,1) = {"
e
R
a
C
v
p
a
g
a
R
z
a
E
a
z
E
a
R
b
"}
(7,1,1) = {"
x
R
z
J
J
J
a
a
a
z
O
J
z
E
q
E
a
R
b
"}
(8,1,1) = {"
H
R
a
p
a
I
a
X
a
Y
z
z
z
z
E
O
R
R
b
"}
(9,1,1) = {"
x
R
z
J
J
a
a
J
a
z
E
O
E
z
R
z
J
R
b
"}
(10,1,1) = {"
e
R
a
s
v
K
J
C
v
R
a
a
z
h
R
E
a
R
b
"}
(11,1,1) = {"
H
R
z
z
O
a
a
z
E
R
a
E
E
O
R
a
a
z
b
"}
(12,1,1) = {"
x
R
J
d
J
l
E
Q
a
R
J
a
z
J
R
J
J
R
b
"}
(13,1,1) = {"
x
R
R
J
a
O
a
J
a
R
R
j
j
R
R
J
a
R
o
"}
(14,1,1) = {"
e
e
R
R
R
R
R
R
R
R
x
x
e
x
R
R
R
R
o
"}
(15,1,1) = {"
H
x
e
x
e
H
x
x
x
x
e
e
x
H
o
o
o
o
o
"}
(16,1,1) = {"
x
H
x
x
H
e
t
e
H
x
x
k
x
e
x
o
o
o
o
"}
(17,1,1) = {"
e
x
e
x
x
x
x
x
x
e
x
x
x
x
e
e
x
o
o
"}
