//MAP CONVERTED BY dmm2tgm.py THIS HEADER COMMENT PREVENTS RECONVERSION, DO NOT REMOVE
"a" = (
/turf/open/water/beach{
	initial_gas_mix = "o2=22;n2=82;TEMP=323.15";
	name = "oasis"
	},
/area/icemoon/surface/outdoors/nospawn)
"e" = (
/turf/open/misc/beach/coast{
	dir = 10;
	initial_gas_mix = "o2=22;n2=82;TEMP=323.15"
	},
/area/icemoon/surface/outdoors/nospawn)
"g" = (
/obj/item/umbrella,
/obj/item/clothing/glasses/sunglasses,
/obj/structure/rack,
/turf/open/misc/beach/sand,
/area/icemoon/surface/outdoors/nospawn)
"j" = (
/turf/open/misc/beach/coast{
	dir = 8;
	initial_gas_mix = "o2=22;n2=82;TEMP=323.15"
	},
/area/icemoon/surface/outdoors/nospawn)
"l" = (
/turf/open/misc/beach/coast/corner{
	dir = 4;
	initial_gas_mix = "o2=22;n2=82;TEMP=323.15"
	},
/area/icemoon/surface/outdoors/nospawn)
"p" = (
/obj/structure/flora/tree/palm/style_random,
/turf/open/misc/beach/sand,
/area/icemoon/surface/outdoors/nospawn)
"t" = (
/obj/structure/flora/tree/palm/style_random,
/obj/structure/flora/bush/sparsegrass/style_random,
/turf/open/misc/beach/sand,
/area/icemoon/surface/outdoors/nospawn)
"u" = (
/turf/open/misc/beach/coast{
	dir = 4;
	initial_gas_mix = "o2=22;n2=82;TEMP=323.15"
	},
/area/icemoon/surface/outdoors/nospawn)
"w" = (
/turf/open/misc/beach/coast{
	initial_gas_mix = "o2=22;n2=82;TEMP=323.15"
	},
/area/icemoon/surface/outdoors/nospawn)
"y" = (
/turf/open/misc/beach/coast/corner{
	dir = 1;
	initial_gas_mix = "o2=22;n2=82;TEMP=323.15"
	},
/area/icemoon/surface/outdoors/nospawn)
"A" = (
/turf/open/misc/beach/sand,
/area/icemoon/surface/outdoors/nospawn)
"C" = (
/mob/living/basic/parrot,
/turf/open/misc/beach/sand,
/area/icemoon/surface/outdoors/nospawn)
"H" = (
/obj/structure/beach_towel,
/obj/structure/fluff/beach_umbrella,
/turf/open/misc/beach/sand,
/area/icemoon/surface/outdoors/nospawn)
"K" = (
/obj/structure/flora/bush/sparsegrass/style_random,
/turf/open/misc/beach/sand,
/area/icemoon/surface/outdoors/nospawn)
"M" = (
/obj/structure/flora/rock/style_random,
/turf/open/misc/beach/sand,
/area/icemoon/surface/outdoors/nospawn)
"N" = (
/obj/item/clothing/suit/costume/hawaiian{
	pixel_y = 12;
	pixel_x = 6
	},
/obj/item/clothing/shoes/sandal/beach{
	pixel_y = -3;
	pixel_x = 6
	},
/turf/open/misc/beach/sand,
/area/icemoon/surface/outdoors/nospawn)
"O" = (
/turf/open/misc/beach/coast{
	dir = 9;
	initial_gas_mix = "o2=22;n2=82;TEMP=323.15"
	},
/area/icemoon/surface/outdoors/nospawn)
"P" = (
/obj/structure/towel_rack/full_beach,
/turf/open/misc/beach/sand,
/area/icemoon/surface/outdoors/nospawn)
"Q" = (
/turf/open/misc/beach/coast{
	dir = 5;
	initial_gas_mix = "o2=22;n2=82;TEMP=323.15"
	},
/area/icemoon/surface/outdoors/nospawn)
"S" = (
/turf/open/misc/beach/coast/corner{
	dir = 8;
	initial_gas_mix = "o2=22;n2=82;TEMP=323.15"
	},
/area/icemoon/surface/outdoors/nospawn)
"T" = (
/turf/open/misc/beach/coast{
	dir = 1;
	initial_gas_mix = "o2=22;n2=82;TEMP=323.15"
	},
/area/icemoon/surface/outdoors/nospawn)
"V" = (
/obj/structure/flora/rock/pile,
/turf/open/misc/beach/sand,
/area/icemoon/surface/outdoors/nospawn)
"W" = (
/turf/open/misc/beach/coast/corner{
	initial_gas_mix = "o2=22;n2=82;TEMP=323.15"
	},
/area/icemoon/surface/outdoors/nospawn)
"Z" = (
/turf/open/misc/beach/coast{
	dir = 6;
	initial_gas_mix = "o2=22;n2=82;TEMP=323.15"
	},
/area/icemoon/surface/outdoors/nospawn)

(1,1,1) = {"
A
A
p
A
K
A
p
M
A
A
K
A
p
A
A
A
"}
(2,1,1) = {"
p
W
u
u
u
u
S
K
A
p
A
A
A
K
K
A
"}
(3,1,1) = {"
A
w
a
a
a
a
Q
u
u
u
S
P
K
A
p
K
"}
(4,1,1) = {"
A
w
a
a
a
a
a
a
a
a
T
g
V
K
A
A
"}
(5,1,1) = {"
K
y
e
a
a
a
a
a
a
a
T
p
A
A
A
A
"}
(6,1,1) = {"
A
K
w
a
a
a
a
a
a
a
Q
S
A
H
A
p
"}
(7,1,1) = {"
A
p
w
a
a
a
a
a
a
a
a
Q
S
N
K
A
"}
(8,1,1) = {"
A
K
w
a
a
a
a
a
a
a
a
a
T
H
A
A
"}
(9,1,1) = {"
A
A
w
a
a
a
a
a
a
a
a
a
T
p
A
K
"}
(10,1,1) = {"
K
M
w
a
a
a
a
a
a
a
a
a
T
H
A
A
"}
(11,1,1) = {"
A
K
w
a
a
a
a
a
a
a
a
a
T
K
A
t
"}
(12,1,1) = {"
A
p
y
e
a
a
a
a
a
a
a
a
T
H
A
A
"}
(13,1,1) = {"
K
C
W
Z
a
a
a
a
a
O
j
j
l
A
A
A
"}
(14,1,1) = {"
p
K
w
a
a
a
a
a
O
l
A
t
K
H
A
t
"}
(15,1,1) = {"
A
p
y
j
j
j
j
j
l
K
A
A
A
V
K
A
"}
(16,1,1) = {"
A
A
K
A
p
A
K
A
p
A
A
p
K
p
A
A
"}
