//MAP CONVERTED BY dmm2tgm.py THIS HEADER COMMENT PREVENTS RECONVERSION, DO NOT REMOVE
"a" = (
/obj/structure/lattice/catwalk{
	invisibility = 50;
	alpha = 150
	},
/turf/open/chasm{
	initial_gas_mix = "o2=22;n2=82;TEMP=318.15"
	},
/area/ruin/unpowered)
"b" = (
/obj/effect/decal/cleanable/dirt/dust,
/obj/effect/decal/cleanable/crayon{
	icon_state = "arrow";
	alpha = 50
	},
/turf/open/floor/iron/terracotta{
	initial_gas_mix = "o2=22;n2=82;TEMP=318.15"
	},
/area/ruin/unpowered)
"c" = (
/obj/structure/railing{
	dir = 1;
	color = "#330000"
	},
/obj/effect/decal/cleanable/dirt/dust,
/turf/open/floor/iron/terracotta{
	initial_gas_mix = "o2=22;n2=82;TEMP=318.15"
	},
/area/ruin/unpowered)
"d" = (
/obj/effect/decal/cleanable/cobweb/cobweb2,
/turf/open/chasm{
	initial_gas_mix = "o2=22;n2=82;TEMP=318.15"
	},
/area/ruin/unpowered)
"f" = (
/turf/open/misc/beach/sand,
/area/icemoon/underground/unexplored)
"g" = (
/obj/effect/decal/cleanable/dirt/dust,
/obj/effect/decal/cleanable/blood/old,
/turf/open/floor/iron/terracotta/small,
/area/ruin/unpowered)
"i" = (
/obj/structure/railing{
	dir = 8;
	color = "#330000"
	},
/turf/open/floor/iron/terracotta{
	initial_gas_mix = "o2=22;n2=82;TEMP=318.15"
	},
/area/ruin/unpowered)
"j" = (
/turf/closed/wall/mineral/sandstone,
/area/ruin/unpowered)
"k" = (
/obj/structure/flora/tree/palm/style_random,
/turf/open/misc/beach/sand,
/area/icemoon/underground/unexplored)
"n" = (
/turf/closed/indestructible/sandstone,
/area/ruin/unpowered)
"p" = (
/obj/structure/lattice/catwalk{
	invisibility = 50;
	alpha = 150
	},
/obj/effect/decal/cleanable/food/salt,
/turf/open/chasm{
	initial_gas_mix = "o2=22;n2=82;TEMP=318.15"
	},
/area/ruin/unpowered)
"q" = (
/obj/structure/railing{
	dir = 9;
	color = "#330000"
	},
/turf/open/floor/iron/terracotta{
	initial_gas_mix = "o2=22;n2=82;TEMP=318.15"
	},
/area/ruin/unpowered)
"r" = (
/obj/structure/lattice/catwalk{
	invisibility = 50;
	alpha = 150
	},
/obj/structure/railing{
	dir = 8;
	color = "#330000";
	invisibility = 50;
	alpha = 150
	},
/turf/open/chasm{
	initial_gas_mix = "o2=22;n2=82;TEMP=318.15"
	},
/area/ruin/unpowered)
"s" = (
/obj/structure/table/bronze,
/obj/item/reagent_containers/cup/glass/trophy/grail/fake/b,
/turf/open/floor/iron/terracotta/small,
/area/ruin/unpowered)
"t" = (
/obj/effect/decal/cleanable/cobweb,
/turf/open/chasm{
	initial_gas_mix = "o2=22;n2=82;TEMP=318.15"
	},
/area/ruin/unpowered)
"u" = (
/obj/structure/railing/corner{
	dir = 1;
	color = "#330000"
	},
/turf/open/floor/iron/terracotta{
	initial_gas_mix = "o2=22;n2=82;TEMP=318.15"
	},
/area/ruin/unpowered)
"v" = (
/obj/structure/railing/corner{
	dir = 4;
	color = "#330000"
	},
/turf/open/floor/iron/terracotta{
	initial_gas_mix = "o2=22;n2=82;TEMP=318.15"
	},
/area/ruin/unpowered)
"y" = (
/turf/open/floor/iron/terracotta/small,
/area/ruin/unpowered)
"A" = (
/obj/structure/railing{
	dir = 5;
	color = "#330000"
	},
/turf/open/floor/iron/terracotta{
	initial_gas_mix = "o2=22;n2=82;TEMP=318.15"
	},
/area/ruin/unpowered)
"D" = (
/turf/template_noop,
/area/template_noop)
"E" = (
/obj/structure/railing{
	dir = 1;
	color = "#330000"
	},
/turf/open/floor/iron/terracotta{
	initial_gas_mix = "o2=22;n2=82;TEMP=318.15"
	},
/area/ruin/unpowered)
"F" = (
/obj/structure/flora/ash/cacti,
/turf/open/misc/beach/sand,
/area/icemoon/underground/unexplored)
"H" = (
/obj/effect/decal/cleanable/dirt/dust,
/turf/open/floor/iron/terracotta/small,
/area/ruin/unpowered)
"I" = (
/obj/structure/flora/bush/sparsegrass/style_random,
/turf/open/misc/beach/sand,
/area/icemoon/underground/unexplored)
"J" = (
/obj/effect/decal/cleanable/dirt/dust,
/obj/effect/light_emitter/fake_outdoors,
/turf/open/floor/iron/terracotta/small,
/area/ruin/unpowered)
"K" = (
/turf/open/chasm{
	initial_gas_mix = "o2=22;n2=82;TEMP=318.15"
	},
/area/ruin/unpowered)
"L" = (
/obj/effect/decal/cleanable/dirt/dust,
/turf/open/floor/iron/terracotta{
	initial_gas_mix = "o2=22;n2=82;TEMP=318.15"
	},
/area/ruin/unpowered)
"N" = (
/obj/structure/mineral_door/sandstone,
/obj/effect/turf_decal/weather/sand,
/turf/open/floor/iron/terracotta{
	initial_gas_mix = "o2=22;n2=82;TEMP=318.15"
	},
/area/ruin/unpowered)
"O" = (
/turf/open/misc/sandy_dirt{
	initial_gas_mix = "o2=22;n2=82;TEMP=318.15"
	},
/area/icemoon/underground/unexplored)
"P" = (
/obj/structure/lattice/catwalk{
	invisibility = 50;
	alpha = 150
	},
/obj/structure/railing{
	dir = 4;
	color = "#330000";
	invisibility = 50;
	alpha = 150
	},
/turf/open/chasm{
	initial_gas_mix = "o2=22;n2=82;TEMP=318.15"
	},
/area/ruin/unpowered)
"Q" = (
/obj/structure/table/bronze,
/obj/item/reagent_containers/cup/glass/trophy/grail/fake,
/turf/open/floor/iron/terracotta/small,
/area/ruin/unpowered)
"R" = (
/obj/structure/railing{
	dir = 4;
	color = "#330000"
	},
/turf/open/floor/iron/terracotta{
	initial_gas_mix = "o2=22;n2=82;TEMP=318.15"
	},
/area/ruin/unpowered)
"S" = (
/turf/open/floor/iron/terracotta{
	initial_gas_mix = "o2=22;n2=82;TEMP=318.15"
	},
/area/ruin/unpowered)
"U" = (
/mob/living/basic/skeleton/templar{
	faction = list("neutral")
	},
/turf/open/floor/iron/terracotta{
	initial_gas_mix = "o2=22;n2=82;TEMP=318.15"
	},
/area/ruin/unpowered)
"V" = (
/obj/structure/railing{
	dir = 4;
	color = "#330000"
	},
/obj/effect/decal/cleanable/dirt/dust,
/turf/open/floor/iron/terracotta{
	initial_gas_mix = "o2=22;n2=82;TEMP=318.15"
	},
/area/ruin/unpowered)
"W" = (
/obj/structure/table/bronze,
/obj/item/reagent_containers/cup/glass/trophy/grail/real,
/turf/open/floor/iron/terracotta/small,
/area/ruin/unpowered)
"Y" = (
/obj/effect/decal/cleanable/crayon{
	icon_state = "arrow";
	alpha = 50
	},
/turf/open/floor/iron/terracotta{
	initial_gas_mix = "o2=22;n2=82;TEMP=318.15"
	},
/area/ruin/unpowered)

(1,1,1) = {"
D
D
D
D
D
D
D
D
D
D
D
D
D
D
D
D
D
D
D
D
D
D
"}
(2,1,1) = {"
D
D
n
n
n
n
n
n
n
n
n
n
n
n
n
n
n
j
j
j
j
D
"}
(3,1,1) = {"
D
n
n
K
K
K
K
K
K
K
K
K
K
K
K
E
H
L
S
j
j
f
"}
(4,1,1) = {"
D
n
t
K
K
K
K
K
K
K
K
K
K
K
K
E
H
S
j
j
f
f
"}
(5,1,1) = {"
D
n
K
K
K
K
K
K
K
K
K
K
K
K
K
c
S
S
j
f
f
I
"}
(6,1,1) = {"
D
n
K
K
K
K
K
K
K
K
K
K
q
i
i
u
L
j
j
k
I
f
"}
(7,1,1) = {"
D
n
K
K
K
K
K
K
K
K
K
K
E
H
y
H
S
j
j
O
F
f
"}
(8,1,1) = {"
D
n
i
i
i
i
i
r
r
r
r
r
u
H
H
y
S
j
f
O
I
f
"}
(9,1,1) = {"
D
n
n
Q
g
L
L
a
a
a
p
a
b
y
y
y
L
j
O
O
f
I
"}
(10,1,1) = {"
D
n
n
s
J
U
L
a
a
a
a
a
Y
S
L
L
S
N
O
O
f
f
"}
(11,1,1) = {"
D
n
n
W
y
S
S
a
p
a
a
a
b
y
H
y
S
j
O
O
f
I
"}
(12,1,1) = {"
D
n
V
V
V
R
R
P
P
P
P
P
v
y
y
H
S
j
f
O
O
f
"}
(13,1,1) = {"
D
n
K
K
K
K
K
K
K
K
K
K
E
y
H
y
S
j
j
O
I
f
"}
(14,1,1) = {"
D
n
K
K
K
K
K
K
K
K
K
K
A
V
V
v
S
j
j
I
k
F
"}
(15,1,1) = {"
D
n
K
K
K
K
K
K
K
K
K
K
K
K
K
c
L
S
j
I
f
f
"}
(16,1,1) = {"
D
n
d
K
K
K
K
K
K
K
K
K
K
K
K
c
H
S
j
j
D
D
"}
(17,1,1) = {"
D
n
n
K
K
K
K
K
K
K
K
K
K
K
K
E
H
L
S
j
j
D
"}
(18,1,1) = {"
D
D
n
n
n
n
n
n
n
n
n
n
n
n
n
n
n
j
j
j
j
D
"}
(19,1,1) = {"
D
D
D
D
D
D
D
D
D
D
D
D
D
D
D
D
D
D
D
D
D
D
"}
