//MAP CONVERTED BY dmm2tgm.py THIS HEADER COMMENT PREVENTS RECONVERSION, DO NOT REMOVE
"a" = (
/turf/closed/wall/mineral/sandstone,
/area/ruin/unpowered)
"c" = (
/obj/structure/closet/crate/necropolis{
	anchored = 1
	},
/obj/item/stack/sheet/mineral/gold{
	amount = 2
	},
/obj/item/stack/sheet/mineral/titanium,
/turf/open/floor/iron/sepia,
/area/ruin/unpowered)
"g" = (
/obj/structure/closet/crate/necropolis{
	anchored = 1
	},
/obj/item/food/grown/apple/gold,
/obj/item/food/grown/apple/gold,
/obj/item/stack/sheet/mineral/diamond,
/obj/item/stack/sheet/bluespace_crystal,
/turf/open/floor/iron/sepia,
/area/ruin/unpowered)
"i" = (
/obj/effect/decal/cleanable/dirt/dust,
/turf/open/floor/iron/sepia,
/area/ruin/unpowered)
"p" = (
/obj/structure/closet/crate/necropolis{
	anchored = 1
	},
/obj/item/stack/sheet/mineral/gold{
	amount = 2
	},
/obj/item/stack/sheet/mineral/silver{
	amount = 2
	},
/obj/item/stack/sheet/iron{
	amount = 4
	},
/turf/open/floor/iron/sepia,
/area/ruin/unpowered)
"q" = (
/obj/structure/closet/crate/necropolis{
	anchored = 1
	},
/obj/item/stack/sheet/mineral/runite,
/obj/item/stack/sheet/mineral/silver{
	amount = 2
	},
/turf/open/floor/iron/sepia,
/area/ruin/unpowered)
"v" = (
/obj/effect/decal/cleanable/dirt/dust,
/obj/structure/ladder,
/turf/open/floor/iron/sepia,
/area/ruin/unpowered)
"S" = (
/obj/effect/mine/explosive/light,
/turf/open/floor/iron/sepia,
/area/ruin/unpowered)
"W" = (
/turf/open/floor/iron/sepia,
/area/ruin/unpowered)
"Y" = (
/turf/template_noop,
/area/template_noop)

(1,1,1) = {"
Y
Y
Y
Y
Y
Y
Y
Y
Y
Y
Y
Y
Y
Y
Y
Y
"}
(2,1,1) = {"
Y
Y
Y
Y
Y
Y
Y
Y
Y
Y
Y
Y
Y
Y
Y
Y
"}
(3,1,1) = {"
Y
Y
Y
Y
Y
Y
Y
Y
Y
Y
Y
Y
Y
Y
Y
Y
"}
(4,1,1) = {"
Y
Y
Y
Y
Y
Y
Y
Y
Y
Y
Y
Y
Y
Y
Y
Y
"}
(5,1,1) = {"
Y
Y
Y
Y
Y
Y
Y
Y
Y
Y
Y
Y
Y
Y
Y
Y
"}
(6,1,1) = {"
Y
Y
Y
Y
Y
Y
Y
Y
Y
Y
Y
Y
Y
Y
Y
Y
"}
(7,1,1) = {"
Y
Y
Y
Y
Y
Y
Y
Y
Y
Y
Y
Y
Y
Y
Y
Y
"}
(8,1,1) = {"
Y
Y
Y
Y
Y
Y
Y
Y
Y
Y
Y
Y
Y
Y
Y
Y
"}
(9,1,1) = {"
Y
Y
Y
Y
Y
Y
Y
Y
Y
Y
Y
Y
Y
Y
Y
Y
"}
(10,1,1) = {"
Y
Y
Y
Y
Y
a
a
a
a
a
Y
Y
Y
Y
Y
Y
"}
(11,1,1) = {"
Y
Y
Y
Y
a
a
a
a
a
a
a
Y
Y
Y
Y
Y
"}
(12,1,1) = {"
Y
Y
Y
a
a
a
a
c
a
a
a
a
Y
Y
Y
Y
"}
(13,1,1) = {"
Y
Y
Y
a
a
a
W
W
i
a
a
a
Y
Y
Y
Y
"}
(14,1,1) = {"
Y
Y
Y
a
a
g
S
v
W
q
a
a
Y
Y
Y
Y
"}
(15,1,1) = {"
Y
Y
Y
a
a
a
W
W
W
a
a
a
Y
Y
Y
Y
"}
(16,1,1) = {"
Y
Y
Y
a
a
a
a
p
a
a
a
a
Y
Y
Y
Y
"}
(17,1,1) = {"
Y
Y
Y
Y
a
a
a
a
a
a
a
Y
Y
Y
Y
Y
"}
(18,1,1) = {"
Y
Y
Y
Y
Y
a
a
a
a
a
Y
Y
Y
Y
Y
Y
"}
(19,1,1) = {"
Y
Y
Y
Y
Y
Y
Y
Y
Y
Y
Y
Y
Y
Y
Y
Y
"}
(20,1,1) = {"
Y
Y
Y
Y
Y
Y
Y
Y
Y
Y
Y
Y
Y
Y
Y
Y
"}
(21,1,1) = {"
Y
Y
Y
Y
Y
Y
Y
Y
Y
Y
Y
Y
Y
Y
Y
Y
"}
(22,1,1) = {"
Y
Y
Y
Y
Y
Y
Y
Y
Y
Y
Y
Y
Y
Y
Y
Y
"}
(23,1,1) = {"
Y
Y
Y
Y
Y
Y
Y
Y
Y
Y
Y
Y
Y
Y
Y
Y
"}
(24,1,1) = {"
Y
Y
Y
Y
Y
Y
Y
Y
Y
Y
Y
Y
Y
Y
Y
Y
"}
(25,1,1) = {"
Y
Y
Y
Y
Y
Y
Y
Y
Y
Y
Y
Y
Y
Y
Y
Y
"}
(26,1,1) = {"
Y
Y
Y
Y
Y
Y
Y
Y
Y
Y
Y
Y
Y
Y
Y
Y
"}
(27,1,1) = {"
Y
Y
Y
Y
Y
Y
Y
Y
Y
Y
Y
Y
Y
Y
Y
Y
"}
