//MAP CONVERTED BY dmm2tgm.py THIS HEADER COMMENT PREVENTS RECONVERSION, DO NOT REMOVE
"a" = (
/turf/open/misc/beach/sand,
/area/icemoon/surface/outdoors/nospawn)
"e" = (
/obj/structure/table/optable/abductor,
/obj/item/cautery/alien,
/turf/open/floor/plating/abductor{
	initial_gas_mix = "LAVALAND_ATMOS"
	},
/area/icemoon/surface/outdoors/nospawn)
"k" = (
/obj/structure/bed/abductor,
/turf/open/floor/plating/abductor{
	initial_gas_mix = "LAVALAND_ATMOS"
	},
/area/icemoon/surface/outdoors/nospawn)
"m" = (
/obj/machinery/abductor/gland_dispenser,
/turf/open/floor/plating/abductor{
	initial_gas_mix = "LAVALAND_ATMOS"
	},
/area/icemoon/surface/outdoors/nospawn)
"q" = (
/obj/structure/table/abductor,
/obj/item/storage/box/alienhandcuffs,
/turf/open/floor/plating/abductor{
	initial_gas_mix = "LAVALAND_ATMOS"
	},
/area/icemoon/surface/outdoors/nospawn)
"t" = (
/obj/machinery/abductor/experiment{
	team_number = 100
	},
/turf/open/floor/plating/abductor{
	initial_gas_mix = "LAVALAND_ATMOS"
	},
/area/icemoon/surface/outdoors/nospawn)
"u" = (
/turf/open/floor/plating/abductor{
	initial_gas_mix = "LAVALAND_ATMOS"
	},
/area/icemoon/surface/outdoors/nospawn)
"y" = (
/obj/structure/table/abductor,
/obj/item/surgicaldrill/alien,
/obj/item/circular_saw/alien,
/turf/open/floor/plating/abductor{
	initial_gas_mix = "LAVALAND_ATMOS"
	},
/area/icemoon/surface/outdoors/nospawn)
"B" = (
/obj/item/hemostat/alien,
/turf/open/floor/plating/abductor{
	initial_gas_mix = "LAVALAND_ATMOS"
	},
/area/icemoon/surface/outdoors/nospawn)
"C" = (
/turf/closed/mineral/sand,
/area/icemoon/surface/outdoors/nospawn)
"F" = (
/obj/machinery/abductor/pad{
	team_number = 100
	},
/turf/open/floor/plating/abductor{
	initial_gas_mix = "LAVALAND_ATMOS"
	},
/area/icemoon/surface/outdoors/nospawn)
"G" = (
/turf/closed/wall/mineral/abductor,
/area/icemoon/surface/outdoors/nospawn)
"I" = (
/obj/item/retractor/alien,
/obj/item/paper/guides/antag/abductor,
/turf/open/floor/plating/abductor{
	initial_gas_mix = "LAVALAND_ATMOS"
	},
/area/icemoon/surface/outdoors/nospawn)
"M" = (
/obj/effect/mob_spawn/corpse/human/abductor,
/turf/open/floor/plating/abductor{
	initial_gas_mix = "LAVALAND_ATMOS"
	},
/area/icemoon/surface/outdoors/nospawn)
"S" = (
/obj/structure/closet/abductor,
/turf/open/floor/plating/abductor{
	initial_gas_mix = "LAVALAND_ATMOS"
	},
/area/icemoon/surface/outdoors/nospawn)
"W" = (
/obj/item/scalpel/alien,
/obj/item/surgical_drapes,
/turf/open/floor/plating/abductor{
	initial_gas_mix = "LAVALAND_ATMOS"
	},
/area/icemoon/surface/outdoors/nospawn)
"X" = (
/turf/template_noop,
/area/template_noop)

(1,1,1) = {"
X
X
C
C
C
C
C
C
C
X
"}
(2,1,1) = {"
X
C
C
C
C
C
C
C
C
C
"}
(3,1,1) = {"
C
C
C
G
C
C
C
C
C
C
"}
(4,1,1) = {"
C
C
G
G
C
C
C
C
C
C
"}
(5,1,1) = {"
C
C
G
t
u
u
C
m
G
C
"}
(6,1,1) = {"
C
C
G
u
B
e
W
y
G
C
"}
(7,1,1) = {"
C
C
G
F
M
u
I
k
G
C
"}
(8,1,1) = {"
C
C
G
G
S
q
S
G
G
C
"}
(9,1,1) = {"
C
C
a
G
G
G
G
G
a
C
"}
(10,1,1) = {"
C
C
a
a
a
a
a
a
C
C
"}
(11,1,1) = {"
C
C
a
a
a
a
a
a
C
C
"}
(12,1,1) = {"
C
C
a
a
a
a
a
a
C
C
"}
(13,1,1) = {"
C
C
a
a
a
a
a
a
C
C
"}
(14,1,1) = {"
C
C
a
a
a
a
a
a
C
C
"}
(15,1,1) = {"
C
C
a
a
a
a
a
a
C
C
"}
(16,1,1) = {"
C
C
a
a
a
a
a
a
C
C
"}
(17,1,1) = {"
C
a
a
a
a
a
a
a
C
a
"}
(18,1,1) = {"
C
C
a
a
a
a
a
a
a
X
"}
(19,1,1) = {"
C
C
a
a
a
a
a
a
X
X
"}
(20,1,1) = {"
C
C
a
a
a
a
a
a
C
X
"}
(21,1,1) = {"
C
a
a
a
a
a
a
a
C
C
"}
(22,1,1) = {"
C
a
a
a
a
a
a
a
C
C
"}
(23,1,1) = {"
C
C
a
a
a
a
a
a
C
C
"}
(24,1,1) = {"
C
C
a
a
a
a
a
a
C
C
"}
(25,1,1) = {"
C
C
a
a
a
a
a
a
C
C
"}
(26,1,1) = {"
a
C
a
a
a
a
a
a
C
X
"}
(27,1,1) = {"
X
C
a
a
a
a
a
a
C
X
"}
(28,1,1) = {"
X
a
X
a
a
a
a
a
X
X
"}
(29,1,1) = {"
X
X
X
a
a
a
a
a
X
a
"}
(30,1,1) = {"
X
X
X
a
a
a
a
a
a
a
"}
