//MAP CONVERTED BY dmm2tgm.py THIS HEADER COMMENT PREVENTS RECONVERSION, DO NOT REMOVE
"a" = (
/turf/template_noop,
/area/template_noop)
"n" = (
/obj/structure/flora/rock/pile/style_random,
/turf/open/misc/beach/sand,
/area/icemoon/underground/unexplored)
"w" = (
/turf/open/misc/beach/sand,
/area/icemoon/underground/unexplored)
"K" = (
/obj/item/pitchfork,
/obj/structure/flora/rock/style_4,
/turf/open/misc/beach/sand,
/area/icemoon/underground/unexplored)
"Z" = (
/turf/open/lava/smooth/sandy,
/area/icemoon/underground/unexplored)

(1,1,1) = {"
a
a
Z
Z
Z
Z
Z
Z
Z
a
a
a
"}
(2,1,1) = {"
a
Z
Z
Z
Z
Z
Z
Z
Z
Z
a
a
"}
(3,1,1) = {"
Z
Z
Z
Z
Z
Z
Z
Z
Z
Z
Z
a
"}
(4,1,1) = {"
Z
Z
Z
w
w
Z
Z
Z
Z
Z
Z
a
"}
(5,1,1) = {"
Z
Z
w
K
n
w
Z
Z
Z
Z
Z
a
"}
(6,1,1) = {"
Z
Z
w
w
w
w
Z
Z
Z
Z
Z
Z
"}
(7,1,1) = {"
Z
Z
Z
Z
Z
w
w
Z
Z
Z
Z
Z
"}
(8,1,1) = {"
Z
Z
Z
Z
Z
w
w
Z
Z
Z
Z
Z
"}
(9,1,1) = {"
Z
Z
Z
Z
Z
Z
w
w
Z
Z
Z
Z
"}
(10,1,1) = {"
Z
Z
Z
Z
Z
Z
Z
w
Z
Z
Z
Z
"}
(11,1,1) = {"
Z
Z
Z
Z
Z
Z
Z
w
Z
Z
Z
Z
"}
(12,1,1) = {"
a
Z
Z
Z
Z
Z
w
w
Z
Z
Z
Z
"}
(13,1,1) = {"
a
Z
Z
Z
Z
Z
w
Z
Z
Z
Z
Z
"}
(14,1,1) = {"
a
a
Z
Z
Z
Z
w
Z
Z
Z
Z
Z
"}
(15,1,1) = {"
a
a
a
Z
Z
Z
w
w
Z
Z
Z
a
"}
(16,1,1) = {"
a
a
a
Z
Z
Z
Z
w
Z
Z
Z
a
"}
(17,1,1) = {"
a
a
a
a
Z
Z
Z
w
w
Z
a
a
"}
(18,1,1) = {"
a
a
a
a
a
Z
Z
Z
w
w
a
a
"}
