//MAP CONVERTED BY dmm2tgm.py THIS HEADER COMMENT PREVENTS RECONVERSION, DO NOT REMOVE
"a" = (
/turf/template_noop,
/area/template_noop)
"c" = (
/turf/open/misc/asteroid/airless,
/area/ruin/space/has_grav)
"d" = (
/turf/closed/mineral/random/high_chance,
/area/ruin/space/has_grav)
"e" = (
/turf/closed/wall/mineral/titanium,
/area/ruin/space/has_grav)
"f" = (
/obj/machinery/door/airlock/titanium,
/turf/open/floor/plating/airless,
/area/ruin/space/has_grav)
"g" = (
/turf/open/floor/plating/airless,
/area/ruin/space/has_grav)
"h" = (
/turf/open/floor/mineral/titanium/blue/airless,
/area/ruin/space/has_grav)
"i" = (
/obj/structure/chair,
/obj/structure/window/reinforced{
	dir = 8
	},
/turf/open/floor/mineral/titanium/blue/airless,
/area/ruin/space/has_grav)
"j" = (
/obj/structure/chair,
/turf/open/floor/mineral/titanium/blue/airless,
/area/ruin/space/has_grav)
"k" = (
/obj/effect/spawner/random/structure/crate_abandoned,
/turf/open/floor/mineral/titanium/blue/airless,
/area/ruin/space/has_grav)
"l" = (
/obj/machinery/power/shuttle_engine/propulsion{
	dir = 4
	},
/turf/open/floor/plating/airless,
/area/ruin/space/has_grav)
"m" = (
/obj/item/shard,
/turf/open/floor/plating/airless,
/area/ruin/space/has_grav)
"n" = (
/obj/structure/chair{
	dir = 8
	},
/turf/open/floor/plating/airless,
/area/ruin/space/has_grav)
"o" = (
/obj/structure/grille,
/turf/open/floor/plating/airless,
/area/ruin/space/has_grav)
"p" = (
/obj/structure/table,
/turf/open/floor/mineral/titanium/blue/airless,
/area/ruin/space/has_grav)
"q" = (
/obj/item/shard,
/obj/structure/chair{
	dir = 8
	},
/turf/open/floor/mineral/titanium/blue/airless,
/area/ruin/space/has_grav)
"r" = (
/obj/structure/chair{
	dir = 1
	},
/obj/structure/window/reinforced{
	dir = 8
	},
/turf/open/floor/mineral/titanium/blue/airless,
/area/ruin/space/has_grav)
"s" = (
/obj/structure/chair{
	dir = 1
	},
/turf/open/floor/plating/airless,
/area/ruin/space/has_grav)
"t" = (
/obj/structure/girder,
/turf/open/floor/plating/airless,
/area/ruin/space/has_grav)
"v" = (
/turf/closed/mineral/random,
/area/ruin/space/has_grav)
"O" = (
/obj/machinery/power/apc/auto_name/directional/north{
	start_charge = 0
	},
/turf/open/floor/plating/airless,
/area/ruin/space/has_grav)

(1,1,1) = {"
a
a
a
a
a
a
a
a
a
a
a
a
a
a
a
a
a
a
a
a
a
v
a
a
a
a
a
a
a
a
a
a
a
a
a
"}
(2,1,1) = {"
a
a
a
a
a
a
a
a
a
a
a
a
a
a
a
a
a
a
a
a
a
a
a
a
v
v
a
a
a
a
a
a
a
a
a
"}
(3,1,1) = {"
a
a
c
c
a
a
a
a
a
a
a
a
a
a
a
a
a
a
a
a
a
a
a
v
v
v
a
a
a
a
a
a
a
a
a
"}
(4,1,1) = {"
a
v
c
c
c
a
a
a
a
a
a
a
a
a
a
a
a
a
a
v
a
a
a
v
v
a
a
a
a
a
a
a
a
a
a
"}
(5,1,1) = {"
v
v
c
c
c
a
a
a
a
a
a
a
a
a
a
a
a
a
a
a
a
a
a
a
a
a
a
a
a
a
a
a
a
a
a
"}
(6,1,1) = {"
v
v
v
v
v
a
a
a
a
a
a
c
c
a
a
a
a
a
a
a
a
a
a
a
a
a
a
a
a
a
a
a
a
a
a
"}
(7,1,1) = {"
v
v
v
v
v
a
a
a
a
a
a
c
c
c
c
c
c
c
a
a
a
a
a
a
a
a
a
a
a
a
a
a
a
a
a
"}
(8,1,1) = {"
a
a
v
v
a
a
a
a
a
a
a
c
c
c
c
c
c
c
v
v
v
a
a
a
a
a
a
a
a
a
a
a
a
a
a
"}
(9,1,1) = {"
a
a
v
v
a
a
a
a
a
v
c
c
c
c
c
c
c
c
c
v
v
a
a
a
a
a
a
a
a
a
a
a
a
a
a
"}
(10,1,1) = {"
a
a
a
a
a
a
a
a
a
v
v
v
c
c
c
c
c
c
c
v
v
v
a
a
a
a
a
a
a
a
a
a
a
a
a
"}
(11,1,1) = {"
a
a
a
a
a
a
a
a
v
v
v
v
v
v
c
c
v
v
v
v
v
v
v
a
a
a
a
a
a
a
a
a
a
a
a
"}
(12,1,1) = {"
a
a
a
a
a
a
a
a
v
v
v
v
d
d
v
v
v
v
v
v
v
v
d
a
a
a
a
a
a
a
v
v
v
a
a
"}
(13,1,1) = {"
a
a
a
a
a
a
a
a
d
d
v
v
d
d
v
v
v
d
v
v
v
v
v
a
a
a
a
a
a
a
a
v
v
v
a
"}
(14,1,1) = {"
a
a
a
a
a
a
a
a
d
d
v
v
v
v
v
v
v
v
v
v
v
v
v
v
a
a
a
a
a
a
v
v
v
v
v
"}
(15,1,1) = {"
a
a
a
a
a
a
a
a
d
d
d
v
v
v
g
g
o
v
v
c
v
v
d
d
a
a
a
a
a
d
v
v
v
c
c
"}
(16,1,1) = {"
a
a
a
a
a
a
a
a
d
d
v
v
c
e
g
m
p
g
e
c
v
v
d
d
a
a
a
a
d
d
v
v
d
c
c
"}
(17,1,1) = {"
a
a
a
a
a
a
a
a
d
v
v
v
c
e
g
n
q
h
e
c
v
v
d
d
a
a
a
d
v
v
v
c
c
c
a
"}
(18,1,1) = {"
a
a
a
a
a
a
a
a
v
v
v
v
c
e
O
h
h
h
e
c
c
v
v
v
a
a
a
v
v
v
v
c
c
c
a
"}
(19,1,1) = {"
a
a
a
a
a
a
a
a
v
v
v
c
c
e
h
h
h
h
e
c
c
c
c
v
a
a
d
v
v
c
c
c
c
c
a
"}
(20,1,1) = {"
a
a
a
a
a
a
a
a
a
v
v
c
c
f
h
h
h
h
f
c
c
c
c
v
a
v
v
v
v
c
c
c
a
a
a
"}
(21,1,1) = {"
a
a
a
a
a
a
a
a
a
v
v
v
c
e
i
h
h
r
e
c
c
c
c
a
a
v
v
v
c
c
c
a
a
a
a
"}
(22,1,1) = {"
a
a
a
a
a
a
v
a
a
v
v
v
c
e
j
h
h
s
t
c
c
c
c
a
a
v
v
c
a
a
a
a
a
a
a
"}
(23,1,1) = {"
a
a
a
a
a
a
a
a
v
v
v
d
c
e
k
h
g
g
g
c
c
a
a
a
a
a
v
c
a
a
a
a
a
a
a
"}
(24,1,1) = {"
a
a
a
v
v
a
a
a
v
v
v
d
c
e
e
e
e
e
e
c
c
a
a
a
a
a
a
a
a
a
a
a
a
a
a
"}
(25,1,1) = {"
a
a
v
v
v
a
a
a
v
v
v
d
c
e
l
l
l
l
e
c
c
a
a
a
a
a
a
a
a
a
a
a
a
a
a
"}
(26,1,1) = {"
a
a
a
v
v
a
a
a
v
v
v
v
v
c
c
c
c
c
c
c
c
a
a
a
a
a
a
a
a
a
a
a
a
a
a
"}
(27,1,1) = {"
a
a
a
a
a
a
a
a
a
v
v
v
c
c
c
c
c
a
a
a
a
a
a
a
a
a
a
a
a
a
a
a
a
a
a
"}
(28,1,1) = {"
a
a
a
a
a
a
a
a
a
a
v
v
c
c
c
c
c
a
a
a
a
a
a
a
a
a
a
a
a
a
a
a
a
a
a
"}
(29,1,1) = {"
a
a
a
a
a
a
a
a
a
a
a
a
a
a
a
a
a
a
a
a
a
a
a
a
a
a
a
a
a
a
a
a
a
a
a
"}
(30,1,1) = {"
a
a
a
a
a
a
a
a
a
a
a
a
a
a
a
a
a
a
a
a
a
a
a
a
a
a
a
a
a
a
a
a
a
a
a
"}
(31,1,1) = {"
a
a
a
a
a
a
a
a
a
a
a
a
a
a
a
a
a
a
a
a
a
a
a
a
a
a
c
c
c
a
a
a
a
a
a
"}
(32,1,1) = {"
a
a
a
a
a
a
a
a
a
a
a
a
a
a
a
a
a
a
a
a
a
a
a
a
a
c
c
v
v
a
a
a
a
a
a
"}
(33,1,1) = {"
a
a
a
a
a
a
a
a
a
a
a
a
a
a
a
a
a
a
a
a
a
a
a
a
a
c
c
d
v
a
a
a
a
a
a
"}
(34,1,1) = {"
a
a
a
a
a
a
a
a
a
a
a
a
a
a
a
a
a
a
a
a
a
a
a
v
a
v
d
v
v
a
a
a
a
a
a
"}
(35,1,1) = {"
a
a
a
a
a
a
a
a
a
a
a
a
a
a
a
a
a
a
a
a
a
a
a
a
a
v
v
a
a
a
a
a
a
a
a
"}
