"ah" = (/obj/machinery/power/tracker,/obj/structure/cable,/turf/open/floor/iron/solarpanel/airless,/area/solars/nerva)
"bq" = (/obj/structure/lattice/catwalk,/obj/machinery/atmospherics/components/unary/outlet_injector/layer2,/turf/template_noop,/area/ruin/space/has_grav/nerva)
"bs" = (/obj/structure/lattice/catwalk,/obj/item/stack/cable_coil/cut,/turf/template_noop,/area/solars/nerva)
"bG" = (/obj/effect/turf_decal/stripes/line{dir = 8},/turf/open/floor/iron/large,/area/ruin/space/has_grav/nerva)
"cc" = (/turf/open/floor/iron/dark/corner{dir = 8},/area/ruin/space/has_grav/nerva)
"cg" = (/obj/machinery/atmospherics/pipe/smart/manifold4w/scrubbers/hidden/layer2{dir = 8},/turf/open/floor/iron/dark,/area/ruin/space/has_grav/nerva)
"et" = (/obj/item/food/deadmouse{desc = "Poor fella."; name = "\proper Tom the Space Mouse"},/turf/template_noop,/area/template_noop)
"eE" = (/obj/effect/turf_decal/tile/purple{dir = 1},/obj/effect/turf_decal/tile/purple{dir = 4},/turf/open/floor/iron,/area/ruin/space/has_grav/nerva)
"fw" = (/obj/effect/mapping_helpers/airlock/cyclelink_helper{dir = 4},/obj/machinery/door/airlock/external/glass,/turf/open/floor/plating,/area/ruin/space/has_grav/nerva)
"fy" = (/obj/structure/cable,/obj/machinery/door/airlock/external/glass,/obj/effect/mapping_helpers/airlock/cyclelink_helper,/turf/open/floor/plating,/area/ruin/space/has_grav/nerva)
"fP" = (/turf/open/floor/iron/dark/corner,/area/ruin/space/has_grav/nerva)
"gp" = (/obj/effect/turf_decal/tile/purple{dir = 4},/turf/open/floor/iron/corner{dir = 4},/area/ruin/space/has_grav/nerva)
"gx" = (/obj/effect/turf_decal/tile/purple{dir = 1},/turf/open/floor/iron/corner{dir = 1},/area/ruin/space/has_grav/nerva)
"gK" = (/obj/structure/cable,/turf/open/floor/plating,/area/ruin/space/has_grav/nerva)
"gX" = (/obj/item/gps/spaceruin,/turf/open/floor/iron/dark,/area/ruin/space/has_grav/nerva)
"hw" = (/obj/machinery/atmospherics/components/unary/tank/air,/obj/machinery/atmospherics/pipe/smart/manifold4w/supply/hidden/layer4,/turf/open/floor/iron/dark,/area/ruin/space/has_grav/nerva)
"hS" = (/obj/structure/cable,/obj/machinery/power/solar_control,/obj/machinery/light/directional{dir = 1},/turf/open/floor/iron/dark/side{dir = 9},/area/ruin/space/has_grav/nerva)
"il" = (/obj/machinery/light/directional{dir = 4},/turf/open/floor/iron/dark/side{dir = 6},/area/ruin/space/has_grav/nerva)
"ji" = (/obj/structure/cable,/turf/open/floor/iron,/area/ruin/space/has_grav/nerva)
"kv" = (/obj/effect/mapping_helpers/airlock/cyclelink_helper{dir = 8},/obj/machinery/door/airlock/external/glass,/turf/open/floor/plating,/area/ruin/space/has_grav/nerva)
"kI" = (/obj/machinery/light/directional{dir = 8},/turf/open/floor/iron/dark/side{dir = 10},/area/ruin/space/has_grav/nerva)
"lY" = (/obj/effect/turf_decal/stripes/corner{dir = 8},/turf/open/floor/iron/dark/corner,/area/ruin/space/has_grav/nerva)
"nd" = (/obj/structure/cable,/obj/machinery/door/airlock/external/glass,/obj/effect/mapping_helpers/airlock/cyclelink_helper{dir = 1},/turf/open/floor/plating,/area/ruin/space/has_grav/nerva)
"nu" = (/obj/effect/mapping_helpers/airlock/cyclelink_helper{dir = 1},/obj/machinery/door/airlock/external/glass,/turf/open/floor/plating,/area/ruin/space/has_grav/nerva)
"ox" = (/obj/machinery/atmospherics/pipe/smart/manifold4w/scrubbers/hidden/layer2{dir = 8},/obj/effect/spawner/structure/window/reinforced,/turf/open/floor/plating,/area/ruin/space/has_grav/nerva)
"pZ" = (/obj/machinery/light/directional,/turf/open/floor/iron/dark/side{dir = 6},/area/ruin/space/has_grav/nerva)
"re" = (/obj/structure/cable,/obj/effect/turf_decal/stripes/corner{dir = 4},/turf/open/floor/iron/dark/corner{dir = 1},/area/ruin/space/has_grav/nerva)
"ro" = (/obj/structure/cable,/obj/machinery/power/terminal{dir = 4},/obj/effect/turf_decal/stripes/line{dir = 1},/turf/open/floor/iron/large,/area/ruin/space/has_grav/nerva)
"vd" = (/obj/machinery/atmospherics/pipe/smart/manifold4w/supply/hidden/layer4,/obj/machinery/atmospherics/pipe/smart/manifold4w/scrubbers/hidden/layer2{dir = 8},/turf/open/floor/iron/large,/area/ruin/space/has_grav/nerva)
"vZ" = (/obj/machinery/airalarm/directional/east,/turf/open/floor/iron/dark,/area/ruin/space/has_grav/nerva)
"wl" = (/obj/structure/cable,/obj/machinery/power/smes/engineering{charge = 0},/obj/effect/turf_decal/stripes/corner{dir = 1},/turf/open/floor/iron/dark/corner{dir = 4},/area/ruin/space/has_grav/nerva)
"xb" = (/turf/open/floor/iron/dark,/area/ruin/space/has_grav/nerva)
"yi" = (/obj/effect/turf_decal/stripes/corner{dir = 4},/turf/open/floor/iron/dark/corner,/area/ruin/space/has_grav/nerva)
"yG" = (/obj/machinery/atmospherics/pipe/smart/manifold4w/supply/hidden/layer4,/obj/machinery/atmospherics/pipe/smart/manifold4w/scrubbers/hidden/layer2{dir = 8},/obj/effect/turf_decal/tile/purple{dir = 1},/obj/effect/turf_decal/tile/purple{dir = 8},/turf/open/floor/iron,/area/ruin/space/has_grav/nerva)
"BD" = (/obj/structure/cable,/obj/machinery/power/apc/auto_name/north,/turf/open/floor/iron/dark/side{dir = 5},/area/ruin/space/has_grav/nerva)
"DE" = (/obj/machinery/light/directional{dir = 8},/turf/open/floor/iron/dark,/area/ruin/space/has_grav/nerva)
"ED" = (/obj/effect/spawner/structure/window/reinforced,/turf/open/floor/plating,/area/ruin/space/has_grav/nerva)
"EI" = (/obj/machinery/atmospherics/pipe/smart/manifold4w/supply/hidden/layer4,/turf/open/floor/iron/dark/corner{dir = 1},/area/ruin/space/has_grav/nerva)
"Fj" = (/turf/open/floor/iron,/area/ruin/space/has_grav/nerva)
"FU" = (/obj/effect/turf_decal/stripes/corner,/turf/open/floor/iron/dark/corner{dir = 8},/area/ruin/space/has_grav/nerva)
"GO" = (/obj/effect/turf_decal/stripes/corner{dir = 1},/turf/open/floor/iron/dark/corner{dir = 8},/area/ruin/space/has_grav/nerva)
"Hl" = (/obj/machinery/spaceship_navigation_beacon,/obj/machinery/atmospherics/pipe/smart/manifold4w/supply/hidden/layer4,/obj/machinery/atmospherics/pipe/smart/manifold4w/scrubbers/hidden/layer2{dir = 8},/turf/open/floor/iron/smooth_large,/area/ruin/space/has_grav/nerva)
"Hp" = (/obj/machinery/atmospherics/components/unary/vent_pump/on/layer4{dir = 1},/turf/open/floor/iron,/area/ruin/space/has_grav/nerva)
"HL" = (/obj/structure/lattice/catwalk,/obj/structure/cable,/turf/template_noop,/area/solars/nerva)
"In" = (/obj/machinery/atmospherics/pipe/smart/manifold4w/supply/hidden/layer4,/obj/machinery/atmospherics/pipe/smart/manifold4w/scrubbers/hidden/layer2{dir = 8},/obj/effect/turf_decal/tile/purple,/obj/effect/turf_decal/tile/purple{dir = 4},/turf/open/floor/iron,/area/ruin/space/has_grav/nerva)
"Iw" = (/obj/machinery/atmospherics/pipe/smart/manifold4w/scrubbers/hidden/layer2{dir = 8},/turf/open/floor/iron,/area/ruin/space/has_grav/nerva)
"Jz" = (/turf/open/floor/iron/corner{dir = 8},/area/ruin/space/has_grav/nerva)
"Ke" = (/turf/open/floor/plating,/area/ruin/space/has_grav/nerva)
"Kf" = (/obj/machinery/atmospherics/components/unary/vent_scrubber/on/layer2{dir = 1},/turf/open/floor/iron,/area/ruin/space/has_grav/nerva)
"Kn" = (/turf/open/floor/iron/large,/area/ruin/space/has_grav/nerva)
"KY" = (/obj/machinery/power/solar,/obj/structure/cable,/turf/open/floor/iron/solarpanel/airless,/area/solars/nerva)
"LX" = (/obj/machinery/light/directional,/turf/open/floor/iron/dark/side{dir = 10},/area/ruin/space/has_grav/nerva)
"Nd" = (/obj/machinery/atmospherics/pipe/smart/manifold4w/scrubbers/hidden/layer2{dir = 8},/turf/open/floor/iron/dark/corner{dir = 4},/area/ruin/space/has_grav/nerva)
"Oh" = (/obj/effect/mapping_helpers/airlock/cyclelink_helper,/obj/machinery/door/airlock/external/glass,/turf/open/floor/plating,/area/ruin/space/has_grav/nerva)
"OB" = (/turf/open/floor/iron/dark/side{dir = 9},/area/ruin/space/has_grav/nerva)
"ON" = (/obj/machinery/atmospherics/pipe/smart/manifold4w/supply/hidden/layer4,/turf/open/floor/iron,/area/ruin/space/has_grav/nerva)
"OO" = (/obj/machinery/gravity_generator/main/station,/turf/open/floor/iron/dark,/area/ruin/space/has_grav/nerva)
"Py" = (/turf/open/floor/iron/corner{dir = 1},/area/ruin/space/has_grav/nerva)
"QB" = (/turf/open/floor/iron/corner{dir = 4},/area/ruin/space/has_grav/nerva)
"Ru" = (/obj/effect/turf_decal/stripes/line,/turf/open/floor/iron/large,/area/ruin/space/has_grav/nerva)
"RD" = (/obj/machinery/light/directional{dir = 4},/turf/open/floor/iron/dark/side{dir = 5},/area/ruin/space/has_grav/nerva)
"RL" = (/obj/effect/turf_decal/stripes/corner{dir = 8},/turf/open/floor/iron/dark/corner{dir = 1},/area/ruin/space/has_grav/nerva)
"RS" = (/obj/machinery/atmospherics/pipe/smart/manifold4w/supply/hidden/layer4,/obj/machinery/atmospherics/components/unary/vent_scrubber/on/layer2,/turf/open/floor/iron,/area/ruin/space/has_grav/nerva)
"Ul" = (/obj/effect/turf_decal/tile/purple,/obj/effect/turf_decal/tile/purple,/turf/open/floor/iron/corner,/area/ruin/space/has_grav/nerva)
"Uv" = (/obj/effect/turf_decal/tile/purple,/obj/effect/turf_decal/tile/purple{dir = 8},/turf/open/floor/iron,/area/ruin/space/has_grav/nerva)
"Uw" = (/obj/effect/turf_decal/stripes/line{dir = 4},/turf/open/floor/iron/large,/area/ruin/space/has_grav/nerva)
"UL" = (/obj/effect/turf_decal/tile/purple{dir = 8},/turf/open/floor/iron/corner{dir = 8},/area/ruin/space/has_grav/nerva)
"Wb" = (/turf/closed/wall/r_wall,/area/ruin/space/has_grav/nerva)
"YB" = (/obj/machinery/atmospherics/pipe/smart/manifold4w/scrubbers/hidden/layer2{dir = 8},/obj/machinery/atmospherics/components/unary/vent_pump/on/layer4,/turf/open/floor/iron,/area/ruin/space/has_grav/nerva)
"Zj" = (/turf/template_noop,/area/template_noop)
"Zp" = (/obj/effect/turf_decal/stripes/corner,/turf/open/floor/iron/dark/corner{dir = 4},/area/ruin/space/has_grav/nerva)
"ZG" = (/turf/open/floor/iron/corner,/area/ruin/space/has_grav/nerva)

(1,1,1) = {"
ZjZjKYKYKYKYKYahKYKYKYKYKYZjZj
ZjZjHLHLHLHLHLHLHLHLHLHLHLZjZj
ZjZjKYKYKYKYKYHLKYKYKYKYKYZjZj
ZjZjKYKYKYKYKYHLKYKYKYKYKYZjZj
ZjZjHLHLHLHLHLHLHLHLHLHLHLZjZj
ZjZjKYKYKYKYKYHLKYKYKYKYKYZjZj
ZjZjKYKYKYKYKYHLKYKYKYKYKYZjZj
ZjZjHLHLHLHLHLHLHLHLHLHLHLZjZj
ZjZjKYKYKYKYKYHLKYKYKYKYKYZjZj
ZjZjZjZjZjZjZjbsetZjZjZjZjZjZj
WbWbWbWbWbZjEDfyEDZjZjZjZjZjZj
WbxbxbxbWbZjEDgKEDZjbqZjZjZjZj
WbxbOOxbWbWbEDndEDWboxWbZjZjZj
WbxbxbxbhwhSrerowlBDcgWbWbZjZj
WbWbDExbEIFjFjKnFjjiNdvZWbZjZj
ZjWbxbOBONPyKnKnKnQBIwRDWbZjZj
EDEDEDRLRSKnUlUvULKnYBZpEDEDED
fwKekvbGvdvdInHlyGvdvdUwfwKekv
EDEDEDGOHpKngpeEgxKnKfyiEDEDED
ZjZjWbkIFjJzKnKnKnZGFjilWbZjZj
ZjZjWbxbccFjFjKnFjFjfPgXWbZjZj
ZjZjWbWbxbLXFURulYpZxbWbWbZjZj
ZjZjZjWbWbWbEDOhEDWbWbWbZjZjZj
ZjZjZjZjZjZjEDKeEDZjZjZjZjZjZj
ZjZjZjZjZjZjEDnuEDZjZjZjZjZjZj
"}
