"a" = (/turf/open/misc/asteroid/basalt/lava_land_surface,/area/ruin/unpowered/redgeneric)
"b" = (/obj/structure/frame/machine/secured,/obj/item/stock_parts/capacitor/redtech,/obj/item/stock_parts/servo/redtech,/turf/open/indestructible/redtech{initial_gas_mix = "LAVALAND_ATMOS"},/area/ruin/unpowered/redgeneric)
"d" = (/obj/item/stack/sheet/mineral/aerialite,/turf/open/indestructible/redtech/altalt{initial_gas_mix = "LAVALAND_ATMOS"},/area/ruin/unpowered/redgeneric)
"e" = (/obj/structure/frame/machine/secured,/obj/item/stock_parts/micro_laser/redtech,/obj/item/stock_parts/scanning_module/redtech,/turf/open/indestructible/redtech{initial_gas_mix = "LAVALAND_ATMOS"},/area/ruin/unpowered/redgeneric)
"g" = (/obj/structure/frame/machine/secured,/obj/item/stock_parts/matter_bin/redtech,/obj/item/stock_parts/power_store/cell/redtech/empty,/turf/open/indestructible/redtech{initial_gas_mix = "LAVALAND_ATMOS"},/area/ruin/unpowered/redgeneric)
"i" = (/obj/item/stack/sheet/mineral/plastitanium,/turf/open/indestructible/redtech/altalt{initial_gas_mix = "LAVALAND_ATMOS"},/area/ruin/unpowered/redgeneric)
"m" = (/obj/item/stack/sheet/mineral/aerialite,/turf/open/indestructible/redtech/alt{initial_gas_mix = "LAVALAND_ATMOS"},/area/ruin/unpowered/redgeneric)
"n" = (/turf/open/indestructible/redtech/alt{initial_gas_mix = "LAVALAND_ATMOS"},/area/ruin/unpowered/redgeneric)
"s" = (/turf/open/indestructible/redtech/altalt{initial_gas_mix = "LAVALAND_ATMOS"},/area/ruin/unpowered/redgeneric)
"w" = (/obj/item/stack/sheet/mineral/resmythril,/turf/open/indestructible/redtech{initial_gas_mix = "LAVALAND_ATMOS"},/area/ruin/unpowered/redgeneric)
"x" = (/obj/structure/redtech_indestructable/heatsink_off,/turf/open/indestructible/redtech{initial_gas_mix = "LAVALAND_ATMOS"},/area/ruin/unpowered/redgeneric)
"D" = (/obj/item/stack/sheet/mineral/plastitanium,/turf/open/indestructible/redtech{initial_gas_mix = "LAVALAND_ATMOS"},/area/ruin/unpowered/redgeneric)
"I" = (/obj/structure/frame/machine/secured,/obj/item/stock_parts/capacitor/redtech,/obj/item/stock_parts/matter_bin/redtech,/turf/open/indestructible/redtech{initial_gas_mix = "LAVALAND_ATMOS"},/area/ruin/unpowered/redgeneric)
"J" = (/obj/structure/frame/machine/secured,/obj/item/stock_parts/scanning_module/redtech,/turf/open/indestructible/redtech{initial_gas_mix = "LAVALAND_ATMOS"},/area/ruin/unpowered/redgeneric)
"K" = (/turf/template_noop,/area/template_noop)
"O" = (/obj/structure/frame/machine/secured,/obj/item/rtechdrive,/turf/open/indestructible/redtech{initial_gas_mix = "LAVALAND_ATMOS"},/area/ruin/unpowered/redgeneric)
"R" = (/turf/open/indestructible/redtech{initial_gas_mix = "LAVALAND_ATMOS"},/area/ruin/unpowered/redgeneric)
"S" = (/turf/closed/indestructible/redtech{initial_gas_mix = "LAVALAND_ATMOS"},/area/ruin/unpowered/redgeneric)
"U" = (/obj/structure/frame/machine/secured,/obj/item/stock_parts/micro_laser/redtech,/obj/item/stock_parts/servo/redtech,/turf/open/indestructible/redtech{initial_gas_mix = "LAVALAND_ATMOS"},/area/ruin/unpowered/redgeneric)
"V" = (/obj/item/stack/sheet/mineral/plastitanium,/turf/open/indestructible/redtech/alt{initial_gas_mix = "LAVALAND_ATMOS"},/area/ruin/unpowered/redgeneric)

(1,1,1) = {"
DaaDDaKKKKaa
waaaaaSSSSaD
aaxIUxxxxxai
KaRnsRRnnsaw
aaxOexxxxgaa
DaRnnsRnnRaK
VaxxbxxxJxaa
DaaaaSSaaaaD
aaaDaKKaDmdV
"}
