"a" = (/turf/template_noop,/area/template_noop)
"c" = (/turf/open/mirage{range = 2; target_turf_y = 4},/area/ruin/unpowered/hearts)
"e" = (/turf/open/indestructible/redtech,/area/ruin/unpowered/hearts)
"f" = (/obj/effect/step_trigger/teleporter/offset{teleport_x_offset = 13},/obj/effect/step_trigger/teleporter/offset{teleport_x_offset = 13},/turf/open/mirage{dir = 8; target_turf_x = 12},/area/ruin/unpowered/hearts)
"h" = (/turf/closed/indestructible/binary{desc = "Something terrible has happened here."},/area/ruin/unpowered/hearts)
"o" = (/obj/structure/redtech_indestructable/heatsink_off,/turf/open/indestructible/redtech,/area/ruin/unpowered/hearts)
"r" = (/turf/open/lava/smooth/lava_land_surface,/area/ruin/unpowered/hearts)
"s" = (/obj/effect/step_trigger/teleporter/offset{teleport_y_offset = 24},/turf/open/mirage{target_turf_y = 23},/area/ruin/unpowered/hearts)
"t" = (/turf/open/mirage{dir = 4; range = 2; target_turf_x = -4},/area/ruin/unpowered/hearts)
"z" = (/obj/structure/redtech_indestructable/server_off,/turf/open/indestructible/redtech,/area/ruin/unpowered/hearts)
"C" = (/obj/structure/redtech_indestructable/server_off,/obj/structure/redtech_indestructable/server_off,/turf/open/indestructible/redtech,/area/ruin/unpowered/hearts)
"D" = (/obj/effect/step_trigger/teleporter/offset{teleport_x_offset = 13},/turf/open/mirage{dir = 8; target_turf_x = 12},/area/ruin/unpowered/hearts)
"F" = (/turf/open/misc/asteroid/basalt/lava_land_surface,/area/ruin/unpowered/hearts)
"G" = (/obj/effect/step_trigger/thrower{direction = 1},/turf/open/indestructible/redtech,/area/ruin/unpowered/hearts)
"H" = (/turf/open/mirage{dir = 8; range = 2; target_turf_x = 4},/area/ruin/unpowered/hearts)
"O" = (/obj/effect/step_trigger/thrower{direction = 8},/turf/open/indestructible/redtech,/area/ruin/unpowered/hearts)
"Q" = (/obj/effect/step_trigger/teleporter/offset{teleport_y_offset = -24},/turf/open/mirage{dir = 1; target_turf_y = -23},/area/ruin/unpowered/hearts)
"R" = (/turf/closed/indestructible/redtech,/area/ruin/unpowered/hearts)
"U" = (/obj/effect/step_trigger/thrower{direction = 4},/turf/open/indestructible/redtech,/area/ruin/unpowered/hearts)
"V" = (/obj/structure/frame/machine/secured,/obj/item/rtechdrive/hearts,/turf/open/indestructible/redtech,/area/ruin/unpowered/hearts)
"Y" = (/obj/effect/spawner/random/environmentally_safe_anomaly/immobile,/turf/open/indestructible/redtech,/area/ruin/unpowered/hearts)

(1,1,1) = {"
aaaaaaaaaaaaaaaaaaaaaaaaaaaaaaaaaaaaaaaaaaaaaaaaaaa
aaaaaaaaaaaaaaaaaaaaFeeFFFeeFaaaaaaaaaaaaaaaaaaaaaa
aaaaaaaaaaaaaaaaaFeFFFeeeeeeeFeeeeFaaaaaaaaaaaaaaaa
aaaaaaaaaaaaaaFeFFFFFFFFFFFFFFeeeeFeFaaaaaaaaaaaaaa
aaaaaaaaaaaaaFFeFFhhhhFFhFFFFFFFFFFeeFFaaaaaaaaaaaa
aaaaaaaaaaaaeFFFFFhFFFFRhRRRFFFRReFFFFFFaaaaaaaaaaa
aaaaaaaaaaeeeFFFeFFFhhFRheeRFFFeeeeeFFFeeFaaaaaaaaa
aaaaaaaaaeeeFFFeeFFFFhhhhhhhhhFFRRReFeFFeFFFaaaaaaa
aaaaaaaaeeeFFFFeoeFFFhFhheeFhFFFFFRRFeFFeFeFaaaaaaa
aaaaaaaeeFFFFFeeeeFFFFFFheFFFFYFeFFFFeeFFFeeFaaaaaa
aaaaaaeeeFFeFFFFFeeFhhhFhFFeeFFFeRFFFFFFFFeFFaaaaaa
aaFFFFFFFFFFFFFFFFFFFFFFFFFFFFFFeeFFRRReFFFFFFaaaaa
aFFFRRRRRRRRRRRRRRRRRRRRRRRRReFeeeFFeeeeFFFFFeaaaaa
aFFFRfeeeeeeeeeeeeeeeeeeeeeeeeFezeFeeeFFFFRRFeeaaaa
aFFRRDeeeeeeeeeeeeeeeeeeeeeeeeFeCeFeoeFeFFeRFeFFaaa
aFFRRRRRRRRRRRRRRRRRRRRRRRRReFFeeeFeeeFFFeoRFFFeaaa
aaFFFFFFFFFFFFFFFFFFFFFFFFFFFFFFFFFFFFFeeeeRFeFeaaa
aaeeFeFFFFFFFFFFeFFFFFFRRRRRFFFFFeeFFFFFFFFFFeFeeaa
aaFeFeFRRRFeRRRFeFFRRFFFFFFFFFRRFFFFReRRRRFeFeFeFFa
aaFFFFFeeeFFeoeFFFRRFFeRRRRReFFRRFeeRezzzRFFFeFeeFa
aFFeeFeeoeeFeeFFeFRFFeRRQQQRReFFRFeeReeeeRFeeeFFFFa
aeFFeFRRRReFeRFeeFFFeRRReeeRRReFFFFeRezzzRFFRRFeFFa
aeeFFFFFFFFFFFFFFFFeRRooeeeooRReFFFeRezRRRFFFFFFFea
aeeFFRRRFFFeeRFFFRFRRRoeeeeeoRRRFRFFReRRFFFRRRFFeea
aFeFFReeeFFFeeFeFRFRHUeezezeeOtRFRFFeeRFFFeeeRFFeea
aeeFFReeeeFFFeFeFRFRHUeeeVeeeOtRFRFFFFFFFeeeeRFFeea
aeeFFReeeFFeFFFeFRFRHUeezezeeOtRFRFFFehFFFeeeRFFeea
aeeFFRRRFFFFFFFFFRFRRRoeeeeeoRRRFRFFhehhFFFRRRFFeea
aeeFFFFFFeFFhFFFFFFeRRooeeeooRReFFFFheeheFFFFFFFeea
aeeFeeeeFFFhhFFeFFFFeRRRGGGRRReFFFFFeehheeFFeeFFeea
aFeFFRReFFhheFeeFFRFFeRRcccRReFFRFFhhehhhehFFeFeeaa
aFeeFFFFFhheFFeeeFRRFFeRRRRReFFRRFFFhhhhhhhhFFFeeaa
aaFeFeFhFheFFeeoeFFRRFFFFFFFFFRRFFeFFeeheeeeFeFeeaa
aaFFFFFhFFFFeeFeeFFFFFFRRRRRFFrFFFeeFFhhhehFFeFFFaa
aaaFeFFFFhFFFFFFFFFeFeFFFFFrrrrFFFFFFFFFFFFFFFFFFaa
aaaeeFFFFFFFFFeeFFheFFFRRRRereRRRFFeeeFFFeeRRFeeaaa
aaaaeeFeeeFReFeRFehehFFeerrrrrrrRRFeoeeRFFeRFFeaaaa
aaaaeeFFeFFReFeeFeheeFFerrrrrrrrrRFeeeeeFeeFFeeaaaa
aaaaaFFFFFFReFFFFehheFFrrrrrrrrrRRFFFFFFFFFFFFaaaaa
aaaaaFeeFFFReeeFehhhhFFRRRereRRRRFFFFeeeFeFeeaaaaaa
aaaaaaeeeFFFFFFFFehehFFFFFrrrFFFFFeFFFFFFFFeeaaaaaa
aaaaaaaeFFFFFeFeFhheFFeFFeFFrrrFeFeReFeFFFeeaaaaaaa
aaaaaaaaFeeFFeeeFFheFFFFeeeFFFFFFFeeeFFFeeeaaaaaaaa
aaaaaaaaaeeeFFReFFFFFFFReeeRFFFeeFFFFFFeeeaaaaaaaaa
aaaaaaaaaaaeeFFeFeeeFeFRsssRFeeeFFeFFFeeeaaaaaaaaaa
aaaaaaaaaaaaeeFFFFFeFeFRRRRRFFeRFFFFeFFFaaaaaaaaaaa
aaaaaaaaaaaaaeFeeFFFFFFFFFFFFFeFFFeeeeaaaaaaaaaaaaa
aaaaaaaaaaaaaaaeeeeeeFFFFFeFFFFFeeeeaaaaaaaaaaaaaaa
aaaaaaaaaaaaaaaaaeeeeeeeeFFFeeeeeeaaaaaaaaaaaaaaaaa
aaaaaaaaaaaaaaaaaaFFFeeeeeeFFeFFaaaaaaaaaaaaaaaaaaa
aaaaaaaaaaaaaaaaaaaaaaaaaaaaaaaaaaaaaaaaaaaaaaaaaaa
"}
