"a" = (/turf/open/indestructible/redtech,/area/template_noop)
"f" = (/obj/structure/redtech_indestructable/server_off,/obj/structure/redtech_indestructable/inert_AV,/turf/open/indestructible/redtech/alt,/area/template_noop)
"g" = (/obj/structure/frame/machine/secured,/obj/item/stock_parts/scanning_module/redtech,/obj/item/stock_parts/scanning_module/redtech,/obj/item/stock_parts/capacitor/redtech,/turf/open/indestructible/redtech/alt,/area/template_noop)
"h" = (/turf/open/indestructible/redtech/altalt,/area/template_noop)
"k" = (/obj/item/stack/sheet/mineral/plastitanium,/turf/open/indestructible/redtech,/area/template_noop)
"l" = (/obj/item/stack/sheet/mineral/aerialite,/turf/open/indestructible/redtech,/area/template_noop)
"m" = (/obj/item/stock_parts/matter_bin/redtech,/obj/item/stock_parts/micro_laser/redtech,/turf/open/indestructible/redtech,/area/template_noop)
"o" = (/turf/closed/indestructible/redtech,/area/template_noop)
"q" = (/obj/structure/redtech_indestructable/inert_AV/worse,/turf/open/indestructible/redtech,/area/template_noop)
"r" = (/obj/structure/redtech_indestructable/inert_AV,/turf/open/indestructible/redtech,/area/template_noop)
"t" = (/obj/item/stock_parts/micro_laser/redtech,/turf/open/indestructible/redtech,/area/template_noop)
"u" = (/obj/item/stock_parts/matter_bin/redtech,/turf/open/indestructible/redtech,/area/template_noop)
"w" = (/obj/structure/frame/machine/secured,/obj/item/stock_parts/scanning_module/redtech,/turf/open/indestructible/redtech/alt,/area/template_noop)
"y" = (/obj/item/rtechdrive/spades,/turf/open/indestructible/redtech,/area/template_noop)
"z" = (/obj/structure/redtech_indestructable/server_off,/turf/open/indestructible/redtech/alt,/area/template_noop)
"A" = (/obj/structure/redtech_indestructable/inert_AV/worse,/turf/open/indestructible/redtech/altalt,/area/template_noop)
"B" = (/obj/structure/frame/machine/secured,/obj/item/stock_parts/scanning_module/redtech,/obj/item/stock_parts/scanning_module/redtech,/obj/item/stock_parts/servo/redtech,/turf/open/indestructible/redtech/alt,/area/template_noop)
"E" = (/obj/structure/redtech_indestructable/server_off,/obj/structure/redtech_indestructable/inert_AV/worse,/turf/open/indestructible/redtech/alt,/area/template_noop)
"I" = (/obj/item/stack/sheet/mineral/aerialite,/turf/open/indestructible/redtech/altalt,/area/template_noop)
"J" = (/turf/template_noop,/area/template_noop)
"K" = (/obj/item/stack/sheet/mineral/plastitanium,/turf/open/indestructible/redtech/altalt,/area/template_noop)
"M" = (/obj/item/stack/sheet/mineral/aerialite,/turf/open/indestructible/redtech/alt,/area/template_noop)
"N" = (/obj/structure/frame/machine/secured,/obj/item/stock_parts/capacitor/redtech,/turf/open/indestructible/redtech/alt,/area/template_noop)
"O" = (/obj/item/stock_parts/power_store/cell/redtech/empty,/turf/open/indestructible/redtech,/area/template_noop)
"Q" = (/obj/structure/frame/machine/secured,/obj/item/stack/sheet/mineral/resmythril,/turf/open/indestructible/redtech/alt,/area/template_noop)
"S" = (/obj/structure/frame/machine/secured,/obj/item/stock_parts/servo/redtech,/turf/open/indestructible/redtech/alt,/area/template_noop)
"X" = (/obj/structure/redtech_indestructable/inert_AV,/turf/open/indestructible/redtech/altalt,/area/template_noop)

(1,1,1) = {"
JJJJJJJJJJJJJJJJJJJJJJJJJJJJJJJJJJJJJ
JJJJJJJoJJJJJJJJJJJJJJJJJJJJJJJoJJJJJ
JJJJJJJJJJJJJkJJJJJJJoJJJJJJJJJJJkJJJ
JJJJJJJJJJJJJJJJJJJJJJJJJJJJJJJJJJJJJ
JJJJkuJJJJJJJJJJJJJJJJJJJJJJJJJJJJJJJ
JJJJJJJJJJJJJJJJJJJJJJJJJJJJJJJJJJJJJ
JJJJJJJJJJJJJJJJJJokJkJJJJJJJJkJJJJJJ
JJJJJJJJJJJJJJJJJJtJJJJJkoJJJJloJJJJJ
JJJJJJJJJJJJJJJkJJJJJJJJJoJJJJJuJJJJJ
JJJJJJJJJJotJJJJJJJJJJJJluJJJJJJJJJJJ
JJJJJJJJJoooJJJJJJJJJJJJJJJJJJJlJJJJJ
JJJJJJJJJOoJJJJJJJJJJJJJJJJJJJJJJJJJJ
JJJJJJJJJJJJJJJJJJJJJJJJJJJJJJJJJJJJJ
JJJkJJJJJJJJJJJJJJJJJJJJJJJJJJJJoJJJJ
JJJlJJJJJJJJJJJJJJJJJJJJJJJJJJJJoJJJJ
JJotJJJJJJJJJJJJJJJlkkJJJJJJJJJJtJJJJ
JJoJJJJJJJJJJJJJkJJoolooJJJJJJJJJJJJJ
JJoJJJJJJJJJJJJklJJJJkkukkJJJJJJJJJJJ
JJJJJJJJJlJJJJJJJJJJJJJooOooJJJJJJJJJ
JJJJJJJJJJJJJJJJJJJJJJJJJlkkJJJJJJoJJ
JJJJJJJJJJJJJJJJJJJJJJJJJJJJJJJJJJJJJ
JoJJJJJJJJJJJJJJJJJJJJJJJJJJJJJJJJJJJ
JJJJJoooooooJJJoJJJooooooooooooooooJJ
JJJJJoaaaalJJkllJlJaoaaaaaaaaaayrroJJ
JJJJJohzzwJJSzQJJwJhohBzzzzzzzzfXooJJ
JJJJoohQNJJNwzQJzSJIohzzgBzfgffEAoJJJ
JJJJoaaalJkklkkJkkkaoaaaaaaaaarrqoJJJ
JJJJohzzQJJJJJJJJQMhoAEfffBzzzfXooJJJ
JJJoohzzzSzNwQJNJJwIoXfzfBgzzzzXoJJJJ
JJJoaaaaaaaalJJlkklkokkaaaaaaarroJJJJ
JJJohzzzzzzzQJNwzSJJJKzzzzfzzfAooJJJJ
JJoohzzzzzzzQJwzQwJwJJzgBzzzffAoJJJkJ
JJoaaaaaaaaaaaalkJJkkJklaaaaarroJJJuJ
JJoooooooooooooooJkloJooooooooooJJJJJ
JJJJJJJJJJJJJJJJJJJJoJJJJJJJJJJJJJJtJ
JJJJlJJJJJJJJJJJJktJJJJJJJJJJJJJJoJJJ
JJJJkmoJJJJJJJJJJJJJJJJJJJJJJJJJJJJJJ
"}
