//MAP CONVERTED BY dmm2tgm.py THIS HEADER COMMENT PREVENTS RECONVERSION, DO NOT REMOVE
"a" = (
/turf/template_noop,
/area/template_noop)
"b" = (
/obj/effect/turf_decal/stripes/line{
	dir = 1
	},
/obj/machinery/power/shuttle_engine/propulsion{
	dir = 1
	},
/turf/open/floor/mineral/plastitanium,
/area/shuttle/arrival)
"c" = (
/obj/docking_port/mobile/arrivals{
	dir = 2;
	name = "omega arrivals shuttle"
	},
/turf/closed/wall/mineral/plastitanium/nodiagonal,
/area/shuttle/arrival)
"d" = (
/turf/closed/wall/mineral/titanium/nodiagonal,
/area/shuttle/arrival)
"e" = (
/obj/effect/turf_decal/stripes/line{
	dir = 1
	},
/obj/effect/spawner/structure/window/reinforced/shuttle,
/obj/machinery/power/shuttle_engine/heater{
	dir = 1
	},
/turf/open/floor/mineral/plastitanium,
/area/shuttle/arrival)
"f" = (
/turf/closed/wall/mineral/titanium,
/area/shuttle/arrival)
"g" = (
/obj/structure/closet/wardrobe/grey{
	anchored = 1
	},
/obj/effect/turf_decal/delivery,
/obj/effect/turf_decal/tile/neutral,
/turf/open/floor/mineral/plastitanium,
/area/shuttle/arrival)
"h" = (
/obj/structure/closet/emcloset{
	anchored = 1
	},
/obj/machinery/vending/wallmed{
	pixel_y = 32
	},
/obj/item/storage/toolbox/emergency,
/obj/item/storage/toolbox/emergency,
/obj/item/clothing/suit/hazardvest,
/obj/item/clothing/suit/hazardvest,
/obj/item/clothing/suit/hazardvest,
/obj/item/clothing/suit/hazardvest,
/obj/effect/turf_decal/delivery,
/obj/effect/turf_decal/tile/neutral,
/obj/effect/turf_decal/tile/neutral{
	dir = 8
	},
/obj/item/clothing/head/utility/hardhat/orange,
/turf/open/floor/mineral/plastitanium,
/area/shuttle/arrival)
"i" = (
/obj/structure/closet/wardrobe/mixed{
	anchored = 1
	},
/obj/effect/turf_decal/delivery,
/obj/effect/turf_decal/tile/neutral{
	dir = 8
	},
/turf/open/floor/mineral/plastitanium,
/area/shuttle/arrival)
"j" = (
/obj/machinery/door/airlock/shuttle,
/obj/effect/turf_decal/stripes/line{
	dir = 4
	},
/obj/effect/turf_decal/stripes/line{
	dir = 8
	},
/turf/open/floor/plating,
/area/shuttle/arrival)
"k" = (
/obj/effect/turf_decal/caution{
	dir = 4
	},
/turf/open/floor/mineral/titanium/white,
/area/shuttle/arrival)
"m" = (
/obj/structure/sign/poster/official/enlist/directional/east,
/turf/open/floor/mineral/titanium/white,
/area/shuttle/arrival)
"p" = (
/obj/effect/spawner/structure/window/reinforced/shuttle,
/turf/open/floor/plating,
/area/shuttle/arrival)
"q" = (
/obj/structure/chair/comfy/shuttle{
	dir = 4
	},
/obj/effect/turf_decal/bot,
/turf/open/floor/mineral/plastitanium,
/area/shuttle/arrival)
"r" = (
/obj/structure/chair/comfy/shuttle{
	dir = 8
	},
/obj/effect/turf_decal/bot,
/turf/open/floor/mineral/plastitanium,
/area/shuttle/arrival)
"s" = (
/obj/structure/table/reinforced,
/obj/item/radio/intercom{
	pixel_x = -30
	},
/obj/item/paper_bin,
/obj/item/pen,
/obj/machinery/light/cold/dim/directional/west,
/turf/open/floor/mineral/plastitanium,
/area/shuttle/arrival)
"t" = (
/obj/effect/turf_decal/caution{
	dir = 8
	},
/turf/open/floor/mineral/titanium/white,
/area/shuttle/arrival)
"u" = (
/obj/structure/table/reinforced,
/obj/machinery/cell_charger,
/turf/open/floor/mineral/plastitanium,
/area/shuttle/arrival)
"v" = (
/turf/open/floor/mineral/titanium/white,
/area/shuttle/arrival)
"w" = (
/obj/structure/closet/crate/internals,
/obj/item/tank/internals/emergency_oxygen,
/obj/item/tank/internals/emergency_oxygen,
/obj/item/tank/internals/emergency_oxygen,
/obj/item/tank/internals/emergency_oxygen,
/obj/item/clothing/mask/breath,
/obj/item/clothing/mask/breath,
/obj/item/clothing/mask/breath,
/obj/item/clothing/mask/breath,
/obj/effect/turf_decal/delivery,
/obj/item/crowbar/large/emergency,
/obj/item/crowbar/large/emergency,
/obj/item/crowbar/large/emergency,
/obj/item/crowbar/large/emergency,
/turf/open/floor/mineral/plastitanium,
/area/shuttle/arrival)
"x" = (
/obj/machinery/door/airlock/shuttle/glass,
/obj/effect/turf_decal/stripes/red/line,
/obj/effect/turf_decal/stripes/red/line{
	dir = 1
	},
/turf/open/floor/plating,
/area/shuttle/arrival)
"y" = (
/obj/machinery/light/small{
	dir = 4
	},
/obj/structure/chair/office/light,
/turf/open/floor/mineral/plastitanium,
/area/shuttle/arrival)
"z" = (
/obj/machinery/computer{
	dir = 1;
	name = "Shuttle computer"
	},
/turf/open/floor/mineral/plastitanium,
/area/shuttle/arrival)
"C" = (
/obj/structure/table/reinforced,
/obj/item/toy/cards/deck,
/obj/machinery/requests_console/directional/east{
	department = "Arrival shuttle";
	name = "Arrival Shuttle Requests Console"
	},
/obj/machinery/light/cold/dim/directional/east,
/turf/open/floor/mineral/plastitanium,
/area/shuttle/arrival)
"F" = (
/obj/structure/sign/nanotrasen,
/turf/closed/wall/mineral/titanium,
/area/shuttle/arrival)
"P" = (
/obj/structure/extinguisher_cabinet{
	pixel_x = -26
	},
/turf/open/floor/mineral/titanium/white,
/area/shuttle/arrival)

(1,1,1) = {"
a
d
f
f
j
p
p
d
p
p
j
F
f
a
a
a
"}
(2,1,1) = {"
b
e
g
P
k
q
q
s
q
q
k
u
f
f
p
p
"}
(3,1,1) = {"
c
d
h
v
v
v
v
v
v
v
v
v
x
y
z
p
"}
(4,1,1) = {"
b
e
i
m
t
r
r
C
r
r
t
w
f
f
p
p
"}
(5,1,1) = {"
a
d
f
f
j
p
p
d
p
p
j
F
f
a
a
a
"}
