//MAP CONVERTED BY dmm2tgm.py THIS HEADER COMMENT PREVENTS RECONVERSION, DO NOT REMOVE
"ce" = (
/obj/structure/etherealball,
/turf/open/floor/light/colour_cycle/dancefloor_b,
/area/shuttle/escape)
"cP" = (
/obj/effect/spawner/random/entertainment/arcade,
/turf/open/floor/eighties,
/area/shuttle/escape)
"dJ" = (
/turf/open/floor/light/colour_cycle/dancefloor_a,
/area/shuttle/escape)
"dY" = (
/obj/structure/etherealball,
/turf/open/floor/light/colour_cycle/dancefloor_a,
/area/shuttle/escape)
"eR" = (
/obj/item/kirbyplants/potty{
	name = "Cake plant"
	},
/turf/open/floor/wood/parquet,
/area/shuttle/escape)
"fX" = (
/obj/structure/chair/stool/bar/directional/east,
/turf/open/floor/wood/parquet,
/area/shuttle/escape)
"gu" = (
/obj/structure/railing/corner/end/flip{
	dir = 4
	},
/obj/structure/railing/corner/end/flip{
	dir = 8
	},
/turf/open/floor/light/colour_cycle/dancefloor_b,
/area/shuttle/escape)
"hD" = (
/obj/machinery/door/airlock/gold/glass,
/obj/effect/mapping_helpers/airlock/access/all/command/general,
/turf/open/floor/eighties,
/area/shuttle/escape)
"hF" = (
/turf/closed/wall/mineral/plastitanium/nodiagonal,
/area/shuttle/escape)
"im" = (
/obj/structure/chair/comfy/lime,
/turf/open/floor/eighties,
/area/shuttle/escape)
"kp" = (
/obj/structure/railing{
	dir = 9
	},
/turf/open/floor/light/colour_cycle/dancefloor_b,
/area/shuttle/escape)
"kJ" = (
/obj/structure/railing/corner/end/flip,
/obj/structure/railing/corner/end{
	dir = 1
	},
/turf/open/floor/light/colour_cycle/dancefloor_b,
/area/shuttle/escape)
"ln" = (
/obj/machinery/vending/games,
/turf/open/floor/eighties,
/area/shuttle/escape)
"nw" = (
/turf/open/floor/wood/parquet,
/area/shuttle/escape)
"nT" = (
/obj/machinery/computer/atmos_alert{
	dir = 4
	},
/turf/open/floor/wood/parquet,
/area/shuttle/escape)
"od" = (
/obj/machinery/power/shuttle_engine/propulsion,
/turf/open/floor/plating/airless,
/area/shuttle/escape)
"pa" = (
/obj/structure/railing{
	dir = 1
	},
/turf/open/floor/light/colour_cycle/dancefloor_a,
/area/shuttle/escape)
"pb" = (
/obj/structure/railing,
/turf/open/floor/light/colour_cycle/dancefloor_a,
/area/shuttle/escape)
"pj" = (
/turf/template_noop,
/area/template_noop)
"pI" = (
/obj/machinery/light/directional/west,
/turf/open/floor/eighties,
/area/shuttle/escape)
"qU" = (
/obj/machinery/light/directional/east,
/obj/structure/table,
/obj/machinery/chem_dispenser/drinks{
	dir = 8
	},
/turf/open/floor/wood/parquet,
/area/shuttle/escape)
"sr" = (
/obj/structure/railing/corner{
	dir = 1
	},
/turf/open/floor/light/colour_cycle/dancefloor_a,
/area/shuttle/escape)
"ss" = (
/obj/docking_port/mobile/emergency{
	name = "Uncle Pete's Rollerdome"
	},
/obj/effect/turf_decal/siding/wood{
	dir = 8
	},
/obj/machinery/door/airlock/grunge,
/turf/open/floor/eighties,
/area/shuttle/escape)
"tG" = (
/turf/closed/wall/mineral/plastitanium,
/area/shuttle/escape)
"uN" = (
/obj/effect/turf_decal/siding/wood/corner,
/turf/open/floor/eighties,
/area/shuttle/escape)
"wf" = (
/obj/effect/spawner/structure/window/reinforced/plasma/plastitanium,
/turf/open/floor/plating/elevatorshaft,
/area/shuttle/escape)
"wn" = (
/obj/machinery/computer/emergency_shuttle{
	dir = 4
	},
/turf/open/floor/eighties,
/area/shuttle/escape)
"wR" = (
/obj/structure/railing/corner{
	dir = 4
	},
/turf/open/floor/light/colour_cycle/dancefloor_b,
/area/shuttle/escape)
"xK" = (
/obj/structure/chair/comfy/brown{
	dir = 4
	},
/obj/effect/turf_decal/siding/wood{
	dir = 8
	},
/turf/open/floor/wood/parquet,
/area/shuttle/escape)
"ze" = (
/obj/structure/railing/corner{
	dir = 8
	},
/turf/open/floor/light/colour_cycle/dancefloor_a,
/area/shuttle/escape)
"zs" = (
/obj/structure/railing{
	dir = 4
	},
/turf/open/floor/light/colour_cycle/dancefloor_a,
/area/shuttle/escape)
"zt" = (
/obj/structure/table/wood,
/obj/item/storage/fancy/cigarettes/cigars/havana{
	pixel_y = 11
	},
/obj/item/lighter{
	pixel_x = 6;
	pixel_y = -2
	},
/obj/effect/turf_decal/siding/wood{
	dir = 8
	},
/turf/open/floor/wood/parquet,
/area/shuttle/escape)
"zx" = (
/obj/effect/spawner/structure/window/reinforced,
/turf/open/floor/plating,
/area/shuttle/escape)
"zZ" = (
/obj/structure/railing{
	dir = 8
	},
/turf/open/floor/light/colour_cycle/dancefloor_a,
/area/shuttle/escape)
"Bm" = (
/obj/structure/table/reinforced,
/obj/effect/fun_balloon/sentience/emergency_shuttle{
	group_name = "snack bar drone at Uncle Pete's Rollerdome"
	},
/obj/item/food/cake/birthday{
	pixel_y = 7
	},
/turf/open/floor/wood/parquet,
/area/shuttle/escape)
"Cg" = (
/turf/open/floor/eighties,
/area/shuttle/escape)
"Dh" = (
/obj/item/reagent_containers/cup/glass/shaker{
	pixel_y = 14;
	pixel_x = 11
	},
/turf/open/floor/wood/parquet,
/area/shuttle/escape)
"Dm" = (
/obj/structure/railing{
	dir = 6
	},
/turf/open/floor/light/colour_cycle/dancefloor_b,
/area/shuttle/escape)
"DZ" = (
/obj/structure/railing/corner,
/turf/open/floor/light/colour_cycle/dancefloor_a,
/area/shuttle/escape)
"Gn" = (
/obj/effect/spawner/random/entertainment/arcade,
/obj/machinery/light/directional/north,
/turf/open/floor/eighties,
/area/shuttle/escape)
"GB" = (
/obj/structure/table,
/obj/machinery/chem_dispenser/drinks/beer{
	dir = 8
	},
/turf/open/floor/wood/parquet,
/area/shuttle/escape)
"Hi" = (
/obj/structure/table/wood,
/obj/item/flashlight/lamp/green{
	pixel_y = 14;
	pixel_x = -3
	},
/obj/item/reagent_containers/cup/glass/bottle/whiskey{
	pixel_y = 10;
	pixel_x = 8
	},
/obj/effect/turf_decal/siding/wood{
	dir = 4
	},
/turf/open/floor/wood/parquet,
/area/shuttle/escape)
"HA" = (
/obj/structure/table,
/obj/item/pizzabox/meat{
	pixel_y = 11
	},
/obj/item/pizzabox/meat{
	pixel_y = 17
	},
/turf/open/floor/wood/parquet,
/area/shuttle/escape)
"HS" = (
/obj/machinery/jukebox/disco/indestructible,
/turf/open/floor/light/colour_cycle/dancefloor_a,
/area/shuttle/escape)
"ID" = (
/obj/effect/turf_decal/siding/wood,
/turf/open/floor/eighties,
/area/shuttle/escape)
"IN" = (
/obj/structure/table/reinforced,
/obj/item/pizzabox/mushroom{
	pixel_y = 11;
	pixel_x = -7
	},
/turf/open/floor/wood/parquet,
/area/shuttle/escape)
"Jq" = (
/obj/machinery/computer/security{
	dir = 8
	},
/turf/open/floor/wood/parquet,
/area/shuttle/escape)
"JR" = (
/obj/structure/table/reinforced,
/obj/item/storage/bag/tray{
	pixel_y = 5
	},
/turf/open/floor/wood/parquet,
/area/shuttle/escape)
"Ky" = (
/obj/effect/spawner/random/vending/snackvend,
/turf/open/floor/eighties,
/area/shuttle/escape)
"KJ" = (
/obj/machinery/power/shuttle_engine/heater,
/obj/structure/window/reinforced/spawner/directional/north,
/turf/open/floor/plating/airless,
/area/shuttle/escape)
"Ox" = (
/obj/effect/turf_decal/siding/wood{
	dir = 4
	},
/turf/open/floor/eighties,
/area/shuttle/escape)
"OG" = (
/obj/machinery/computer/communications{
	dir = 8
	},
/turf/open/floor/wood/parquet,
/area/shuttle/escape)
"ON" = (
/obj/machinery/vending/donksofttoyvendor,
/turf/open/floor/eighties,
/area/shuttle/escape)
"PN" = (
/obj/structure/table/reinforced,
/obj/item/storage/box/drinkingglasses{
	pixel_y = 13
	},
/obj/item/storage/box/drinkingglasses{
	pixel_y = 5;
	pixel_x = 7
	},
/turf/open/floor/wood/parquet,
/area/shuttle/escape)
"Qf" = (
/obj/machinery/computer/crew{
	dir = 4
	},
/turf/open/floor/wood/parquet,
/area/shuttle/escape)
"Qv" = (
/obj/structure/table/reinforced,
/obj/item/pizzabox/meat{
	pixel_y = -1
	},
/obj/item/pizzabox/pineapple{
	pixel_y = 7;
	pixel_x = 6
	},
/turf/open/floor/wood/parquet,
/area/shuttle/escape)
"QD" = (
/obj/structure/railing/corner/end/flip{
	dir = 1
	},
/obj/structure/railing/corner/end,
/turf/open/floor/light/colour_cycle/dancefloor_b,
/area/shuttle/escape)
"QO" = (
/obj/effect/turf_decal/siding/wood{
	dir = 8
	},
/obj/machinery/door/airlock/grunge,
/turf/open/floor/wood,
/area/shuttle/escape)
"Rp" = (
/obj/structure/railing{
	dir = 5
	},
/turf/open/floor/light/colour_cycle/dancefloor_b,
/area/shuttle/escape)
"Rs" = (
/obj/structure/railing{
	dir = 10
	},
/turf/open/floor/light/colour_cycle/dancefloor_b,
/area/shuttle/escape)
"Ry" = (
/turf/open/floor/light/colour_cycle/dancefloor_b,
/area/shuttle/escape)
"Tx" = (
/obj/structure/table/wood,
/obj/item/clothing/head/soft/green{
	flipped = 1;
	pixel_x = 7;
	pixel_y = 6
	},
/obj/item/clothing/glasses/sunglasses,
/obj/item/clothing/suit/costume/hawaiian,
/turf/open/floor/eighties,
/area/shuttle/escape)
"UT" = (
/obj/structure/railing/corner/end{
	dir = 4
	},
/obj/structure/railing/corner/end{
	dir = 8
	},
/turf/open/floor/light/colour_cycle/dancefloor_b,
/area/shuttle/escape)
"VR" = (
/obj/machinery/vending/boozeomat,
/turf/open/floor/wood/parquet,
/area/shuttle/escape)
"VS" = (
/mob/living/basic/drone/snowflake/bardrone,
/turf/open/floor/wood/parquet,
/area/shuttle/escape)
"We" = (
/obj/structure/chair/comfy/brown{
	dir = 8
	},
/obj/effect/turf_decal/siding/wood{
	dir = 4
	},
/turf/open/floor/wood/parquet,
/area/shuttle/escape)
"Wg" = (
/obj/effect/spawner/random/vending/colavend,
/obj/effect/turf_decal/siding/wood{
	dir = 4
	},
/turf/open/floor/eighties,
/area/shuttle/escape)
"Wl" = (
/obj/structure/rack,
/obj/item/clothing/shoes/wheelys/rollerskates,
/obj/item/clothing/shoes/wheelys/rollerskates,
/obj/item/clothing/shoes/wheelys/rollerskates,
/obj/item/clothing/shoes/wheelys/rollerskates,
/obj/item/clothing/shoes/wheelys/rollerskates,
/obj/item/clothing/shoes/wheelys/rollerskates,
/obj/item/clothing/shoes/wheelys/rollerskates,
/obj/item/clothing/shoes/wheelys/rollerskates,
/obj/item/clothing/shoes/wheelys/rollerskates,
/obj/item/clothing/shoes/wheelys/rollerskates,
/obj/item/clothing/shoes/wheelys/rollerskates,
/obj/item/clothing/shoes/wheelys/rollerskates,
/obj/item/clothing/shoes/wheelys/rollerskates,
/obj/item/clothing/shoes/wheelys/rollerskates,
/obj/item/clothing/shoes/wheelys/rollerskates,
/turf/open/floor/eighties,
/area/shuttle/escape)
"Yr" = (
/obj/machinery/light/directional/south,
/turf/open/floor/eighties,
/area/shuttle/escape)
"Zo" = (
/obj/effect/turf_decal/siding/wood{
	dir = 6
	},
/obj/effect/turf_decal/siding/wood/corner,
/turf/open/floor/eighties,
/area/shuttle/escape)

(1,1,1) = {"
pj
pj
pj
pj
tG
tG
tG
wf
tG
ss
tG
wf
wf
wf
tG
hF
tG
QO
tG
wf
tG
pj
"}
(2,1,1) = {"
pj
tG
tG
tG
hF
dY
uN
Cg
Cg
Cg
Cg
Cg
Cg
Cg
Cg
Cg
ce
Cg
pI
Ky
tG
tG
"}
(3,1,1) = {"
tG
tG
nT
Qf
zx
ln
Cg
Cg
Cg
kp
zZ
QD
zZ
Rs
Cg
Cg
Cg
uN
Ox
Wg
KJ
od
"}
(4,1,1) = {"
wf
Hi
We
We
zx
cP
Cg
Cg
kp
sr
Ry
dJ
Ry
ze
Rs
Cg
uN
Zo
nw
eR
KJ
od
"}
(5,1,1) = {"
wf
wn
Cg
Cg
zx
cP
Cg
Cg
pa
Ry
dJ
Ry
dJ
Ry
pb
Wl
ID
nw
fX
fX
KJ
od
"}
(6,1,1) = {"
wf
im
Cg
Yr
zx
Gn
Cg
Cg
UT
dJ
Ry
HS
Ry
dJ
gu
Cg
ID
fX
Qv
JR
KJ
od
"}
(7,1,1) = {"
wf
Tx
Cg
Cg
hD
Cg
Cg
Cg
pa
Ry
dJ
Ry
dJ
Ry
pb
Wl
ID
JR
IN
nw
KJ
od
"}
(8,1,1) = {"
wf
zt
xK
xK
zx
ON
Cg
Cg
Rp
wR
Ry
dJ
Ry
DZ
Dm
Cg
ID
Bm
VS
nw
KJ
od
"}
(9,1,1) = {"
tG
tG
Jq
OG
zx
ln
Cg
Cg
Cg
Rp
zs
kJ
zs
Dm
Cg
Cg
ID
PN
Dh
HA
KJ
od
"}
(10,1,1) = {"
pj
tG
tG
tG
hF
ce
Cg
Cg
Cg
Cg
Cg
Cg
Cg
Cg
Cg
Cg
dY
VR
qU
GB
tG
tG
"}
(11,1,1) = {"
pj
pj
pj
pj
tG
tG
tG
wf
tG
tG
tG
wf
wf
wf
tG
tG
tG
wf
tG
wf
tG
pj
"}
