"ab" = (/obj/machinery/light/very_dim/directional/east,/turf/open/floor/fakespace,/area/heretic_sacrifice/void)
"cd" = (/obj/effect/decal/cleanable/blood/old,/turf/open/floor/plating/ashplanet/wateryrock{initial_gas_mix = "o2=22;n2=82;TEMP=293.15"; planetary_atmos = 0; slowdown = 0},/area/heretic_sacrifice/ash)
"cH" = (/obj/item/toy/plush/lizard_plushie/green{desc = "An adorable stuffed toy that resembles a green lizardperson. This one fills you with dread to look at."; name = "Invokes-The-Gods"},/turf/open/floor/plating/airless,/area/space/nearstation)
"cS" = (/turf/open/indestructible/necropolis/air,/area/heretic_sacrifice/flesh)
"dE" = (/obj/structure/stone_tile/block/cracked{dir = 1},/turf/open/floor/plating/dirt/jungle/dark{planetary_atmos = 0; slowdown = 0},/area/heretic_sacrifice/ash)
"dX" = (/obj/effect/turf_decal/weather/dirt{dir = 6},/turf/open/floor/plating/ashplanet/wateryrock{initial_gas_mix = "o2=22;n2=82;TEMP=293.15"; planetary_atmos = 0; slowdown = 0},/area/heretic_sacrifice/ash)
"dZ" = (/obj/effect/decal/fakelattice{density = 0},/turf/open/floor/plating/ironsand,/area/heretic_sacrifice/rust)
"fh" = (/obj/structure/cable,/turf/open/floor/plating,/area/heretic_sacrifice/rust)
"gJ" = (/obj/structure/cable,/turf/open/floor/plating/rust,/area/heretic_sacrifice/rust)
"jg" = (/obj/effect/decal/cleanable/dirt,/obj/effect/decal/fakelattice{density = 0},/turf/open/floor/plating,/area/heretic_sacrifice/rust)
"kA" = (/obj/structure/bonfire/prelit,/turf/open/floor/plating/dirt/jungle/wasteland{planetary_atmos = 0; slowdown = 0},/area/heretic_sacrifice/ash)
"lb" = (/obj/effect/decal/remains/human,/turf/open/indestructible/necropolis/air,/area/heretic_sacrifice/flesh)
"lz" = (/obj/effect/decal/cleanable/dirt/dust,/turf/open/floor/plating/ashplanet/wateryrock{initial_gas_mix = "o2=22;n2=82;TEMP=293.15"; planetary_atmos = 0; slowdown = 0},/area/heretic_sacrifice/ash)
"lB" = (/obj/effect/decal/cleanable/dirt,/obj/effect/landmark/heretic/flesh,/turf/open/indestructible/necropolis/air,/area/heretic_sacrifice/flesh)
"mb" = (/obj/effect/turf_decal/weather,/obj/structure/cable,/turf/open/floor/plating/rust,/area/heretic_sacrifice/rust)
"mG" = (/obj/effect/turf_decal/trimline/brown/line{dir = 1},/turf/open/floor/plating,/area/heretic_sacrifice/rust)
"mR" = (/obj/machinery/light/floor,/obj/effect/decal/fakelattice{density = 0},/turf/open/floor/plating/ironsand,/area/heretic_sacrifice/rust)
"mZ" = (/obj/machinery/light/very_dim/directional/south,/turf/open/floor/plating/asteroid,/area/heretic_sacrifice/void)
"nG" = (/obj/effect/turf_decal/weather/dirt{dir = 10},/turf/open/floor/plating/ashplanet/wateryrock{initial_gas_mix = "o2=22;n2=82;TEMP=293.15"; planetary_atmos = 0; slowdown = 0},/area/heretic_sacrifice/ash)
"nL" = (/obj/structure/stone_tile/block/burnt{dir = 1},/turf/open/floor/plating/ashplanet/wateryrock{initial_gas_mix = "o2=22;n2=82;TEMP=293.15"; planetary_atmos = 0; slowdown = 0},/area/heretic_sacrifice/ash)
"nP" = (/obj/effect/landmark/heretic/ash,/turf/open/floor/plating/dirt/jungle/wasteland{planetary_atmos = 0; slowdown = 0},/area/heretic_sacrifice/ash)
"oh" = (/turf/open/floor/plating/asteroid,/area/heretic_sacrifice/void)
"oC" = (/obj/effect/decal/cleanable/blood/old,/obj/effect/landmark/heretic/void,/turf/open/floor/plating/asteroid,/area/heretic_sacrifice/void)
"ps" = (/obj/effect/turf_decal/weather,/turf/open/floor/plating,/area/heretic_sacrifice/rust)
"pt" = (/obj/effect/turf_decal/trimline/brown/corner{dir = 1},/turf/open/floor/plating/rust,/area/heretic_sacrifice/rust)
"pN" = (/obj/structure/stone_tile/slab,/obj/effect/decal/cleanable/dirt/dust,/turf/open/floor/plating/ashplanet/wateryrock{initial_gas_mix = "o2=22;n2=82;TEMP=293.15"; planetary_atmos = 0; slowdown = 0},/area/heretic_sacrifice/ash)
"qu" = (/obj/effect/landmark/heretic/rust,/turf/open/floor/plating,/area/heretic_sacrifice/rust)
"qM" = (/obj/effect/landmark/heretic/void,/turf/open/floor/plating/asteroid,/area/heretic_sacrifice/void)
"rv" = (/obj/effect/decal/cleanable/blood/old,/turf/open/indestructible/necropolis/air,/area/heretic_sacrifice/flesh)
"sb" = (/obj/effect/turf_decal/weather/dirt{dir = 9},/obj/effect/decal/cleanable/oil,/turf/open/floor/plating/ashplanet/wateryrock{initial_gas_mix = "o2=22;n2=82;TEMP=293.15"; planetary_atmos = 0; slowdown = 0},/area/heretic_sacrifice/ash)
"tj" = (/obj/effect/decal/cleanable/dirt,/obj/effect/gibspawner/human,/turf/open/floor/stone,/area/heretic_sacrifice/flesh)
"tF" = (/obj/effect/turf_decal/trimline/brown/corner,/turf/open/floor/plating/rust,/area/heretic_sacrifice/rust)
"tH" = (/obj/effect/turf_decal/weather/dirt,/turf/open/floor/plating/ashplanet/wateryrock{initial_gas_mix = "o2=22;n2=82;TEMP=293.15"; planetary_atmos = 0; slowdown = 0},/area/heretic_sacrifice/ash)
"ui" = (/turf/open/floor/stone,/area/heretic_sacrifice/flesh)
"uu" = (/obj/effect/decal/cleanable/dirt,/turf/open/floor/plating/rust,/area/heretic_sacrifice/rust)
"uT" = (/obj/effect/turf_decal/trimline/brown/line{dir = 4},/turf/open/floor/plating,/area/heretic_sacrifice/rust)
"vs" = (/obj/effect/gibspawner/generic/animal,/turf/open/floor/stone,/area/heretic_sacrifice/flesh)
"vv" = (/obj/structure/stone_tile/block{dir = 8},/turf/open/floor/plating/dirt/jungle/dark{planetary_atmos = 0; slowdown = 0},/area/heretic_sacrifice/ash)
"vZ" = (/obj/effect/decal/cleanable/blood/old,/obj/effect/landmark/heretic/flesh,/turf/open/indestructible/necropolis/air,/area/heretic_sacrifice/flesh)
"wt" = (/obj/effect/decal/cleanable/oil,/turf/open/floor/plating/ashplanet/wateryrock{initial_gas_mix = "o2=22;n2=82;TEMP=293.15"; planetary_atmos = 0; slowdown = 0},/area/heretic_sacrifice/ash)
"wC" = (/obj/effect/decal/cleanable/ash/large{pixel_x = -2; pixel_y = -8},/obj/effect/decal/cleanable/dirt/dust,/turf/open/floor/plating/dirt/jungle/dark{planetary_atmos = 0; slowdown = 0},/area/heretic_sacrifice/ash)
"wE" = (/obj/structure/stone_tile/block{dir = 1},/turf/open/floor/plating/dirt/jungle/dark{planetary_atmos = 0; slowdown = 0},/area/heretic_sacrifice/ash)
"wS" = (/turf/open/floor/plating/dirt/jungle/dark{planetary_atmos = 0; slowdown = 0},/area/heretic_sacrifice/ash)
"wY" = (/turf/open/floor/glass{desc = "A peek into the other side."; name = "void glass floor"},/area/heretic_sacrifice/void)
"xi" = (/obj/effect/turf_decal/weather/dirt{dir = 5},/turf/open/floor/plating/ashplanet/wateryrock{initial_gas_mix = "o2=22;n2=82;TEMP=293.15"; planetary_atmos = 0; slowdown = 0},/area/heretic_sacrifice/ash)
"xV" = (/obj/effect/decal/cleanable/blood/old,/turf/open/floor/stone,/area/heretic_sacrifice/flesh)
"yy" = (/obj/effect/decal/cleanable/dirt,/obj/effect/gibspawner/generic/animal,/obj/structure/bonfire/prelit,/turf/open/floor/stone,/area/heretic_sacrifice/flesh)
"yC" = (/obj/effect/turf_decal/trimline/brown/line{dir = 8},/turf/open/floor/plating/rust,/area/heretic_sacrifice/rust)
"zb" = (/obj/structure/stone_tile/cracked{dir = 1},/turf/open/floor/plating/ashplanet/wateryrock{initial_gas_mix = "o2=22;n2=82;TEMP=293.15"; planetary_atmos = 0; slowdown = 0},/area/heretic_sacrifice/ash)
"zU" = (/obj/effect/decal/fakelattice{density = 0},/turf/open/floor/plating,/area/heretic_sacrifice/rust)
"AH" = (/obj/effect/decal/cleanable/dirt,/obj/effect/turf_decal/trimline/brown/corner{dir = 4},/turf/open/floor/plating,/area/heretic_sacrifice/rust)
"AN" = (/obj/effect/decal/cleanable/dirt,/turf/open/floor/plating/ironsand,/area/heretic_sacrifice/rust)
"AO" = (/turf/open/floor/fakespace,/area/heretic_sacrifice/void)
"Bv" = (/obj/effect/decal/cleanable/food/salt,/obj/effect/landmark/heretic/flesh,/turf/open/indestructible/necropolis/air,/area/heretic_sacrifice/flesh)
"Bw" = (/turf/open/floor/plating/ashplanet/wateryrock{initial_gas_mix = "o2=22;n2=82;TEMP=293.15"; planetary_atmos = 0; slowdown = 0},/area/heretic_sacrifice/ash)
"By" = (/obj/effect/decal/cleanable/dirt,/obj/effect/turf_decal/weather,/turf/open/floor/plating/rust,/area/heretic_sacrifice/rust)
"Cf" = (/obj/effect/decal/cleanable/dirt,/obj/effect/decal/fakelattice{density = 0},/turf/open/floor/plating/ironsand,/area/heretic_sacrifice/rust)
"Ck" = (/obj/effect/turf_decal/trimline/brown/line{dir = 1},/turf/open/floor/plating/rust,/area/heretic_sacrifice/rust)
"CV" = (/obj/effect/turf_decal/weather/dirt{dir = 9},/turf/open/floor/plating/ashplanet/wateryrock{initial_gas_mix = "o2=22;n2=82;TEMP=293.15"; planetary_atmos = 0; slowdown = 0},/area/heretic_sacrifice/ash)
"DL" = (/obj/effect/turf_decal/weather/dirt{dir = 1},/turf/open/floor/plating/ashplanet/wateryrock{initial_gas_mix = "o2=22;n2=82;TEMP=293.15"; planetary_atmos = 0; slowdown = 0},/area/heretic_sacrifice/ash)
"ER" = (/turf/open/floor/plating/ironsand,/area/heretic_sacrifice/rust)
"Fd" = (/turf/closed/indestructible/riveted,/area/space)
"Gl" = (/obj/effect/turf_decal/weather/dirt{dir = 4},/turf/open/floor/plating/ashplanet/wateryrock{initial_gas_mix = "o2=22;n2=82;TEMP=293.15"; planetary_atmos = 0; slowdown = 0},/area/heretic_sacrifice/ash)
"GI" = (/obj/structure/stone_tile/block,/turf/open/floor/plating/dirt/jungle/dark{planetary_atmos = 0; slowdown = 0},/area/heretic_sacrifice/ash)
"HE" = (/obj/effect/decal/cleanable/blood/old,/obj/structure/cable,/turf/open/floor/plating/rust,/area/heretic_sacrifice/rust)
"HQ" = (/turf/closed/indestructible/necropolis,/area/heretic_sacrifice/flesh)
"Ie" = (/obj/structure/stone_tile/cracked{dir = 4},/obj/structure/stone_tile/block/cracked{dir = 10},/turf/open/floor/plating/ashplanet/wateryrock{initial_gas_mix = "o2=22;n2=82;TEMP=293.15"; planetary_atmos = 0; slowdown = 0},/area/heretic_sacrifice/ash)
"Ii" = (/obj/effect/decal/cleanable/ash/large,/obj/effect/decal/cleanable/dirt/dust,/obj/effect/landmark/heretic/ash,/turf/open/floor/plating/dirt/jungle/wasteland{planetary_atmos = 0; slowdown = 0},/area/heretic_sacrifice/ash)
"Je" = (/obj/effect/turf_decal/weather,/turf/open/floor/plating/rust,/area/heretic_sacrifice/rust)
"Jy" = (/obj/effect/decal/cleanable/dirt,/obj/effect/decal/remains/human,/turf/open/floor/plating/ironsand,/area/heretic_sacrifice/rust)
"JA" = (/obj/effect/decal/cleanable/dirt,/obj/structure/bonfire/prelit,/turf/open/floor/stone,/area/heretic_sacrifice/flesh)
"JJ" = (/obj/effect/decal/cleanable/dirt,/obj/effect/decal/cleanable/dirt,/turf/open/floor/stone,/area/heretic_sacrifice/flesh)
"Ku" = (/obj/effect/decal/cleanable/dirt/dust,/turf/open/floor/plating/dirt/jungle/dark{planetary_atmos = 0; slowdown = 0},/area/heretic_sacrifice/ash)
"Kz" = (/obj/effect/decal/cleanable/ash,/turf/open/floor/plating/dirt/jungle/dark{planetary_atmos = 0; slowdown = 0},/area/heretic_sacrifice/ash)
"KP" = (/obj/structure/no_effect_signpost/void,/turf/open/floor/plating/asteroid,/area/heretic_sacrifice/void)
"La" = (/turf/closed/indestructible/riveted/plastinum,/area/heretic_sacrifice/void)
"LA" = (/obj/effect/decal/cleanable/ash,/obj/effect/decal/cleanable/ash{pixel_x = 4; pixel_y = 4},/obj/effect/decal/cleanable/dirt/dust,/turf/open/floor/plating/dirt/jungle/dark{planetary_atmos = 0; slowdown = 0},/area/heretic_sacrifice/ash)
"Mf" = (/obj/effect/decal/cleanable/plasma,/obj/effect/landmark/heretic/ash,/turf/open/floor/plating/dirt/jungle/wasteland{planetary_atmos = 0; slowdown = 0},/area/heretic_sacrifice/ash)
"MZ" = (/obj/structure/bonfire/prelit,/turf/open/floor/stone,/area/heretic_sacrifice/flesh)
"Nh" = (/obj/effect/decal/fakelattice{density = 0},/turf/open/floor/plating/rust,/area/heretic_sacrifice/rust)
"NA" = (/obj/structure/stone_tile/surrounding_tile,/turf/open/floor/plating/ashplanet/wateryrock{initial_gas_mix = "o2=22;n2=82;TEMP=293.15"; planetary_atmos = 0; slowdown = 0},/area/heretic_sacrifice/ash)
"NQ" = (/obj/effect/turf_decal/weather/dirt{dir = 1},/obj/effect/decal/cleanable/blood/old,/turf/open/floor/plating/ashplanet/wateryrock{initial_gas_mix = "o2=22;n2=82;TEMP=293.15"; planetary_atmos = 0; slowdown = 0},/area/heretic_sacrifice/ash)
"OD" = (/obj/structure/stone_tile/block/burnt{dir = 4},/turf/open/floor/plating/dirt/jungle/dark{planetary_atmos = 0; slowdown = 0},/area/heretic_sacrifice/ash)
"OG" = (/obj/structure/stone_tile/block/cracked,/obj/effect/decal/cleanable/dirt/dust,/obj/effect/turf_decal/weather/dirt{dir = 5},/turf/open/floor/plating/ashplanet/wateryrock{initial_gas_mix = "o2=22;n2=82;TEMP=293.15"; planetary_atmos = 0; slowdown = 0},/area/heretic_sacrifice/ash)
"Pl" = (/obj/structure/stone_tile/burnt,/turf/open/floor/plating/ashplanet/wateryrock{initial_gas_mix = "o2=22;n2=82;TEMP=293.15"; planetary_atmos = 0; slowdown = 0},/area/heretic_sacrifice/ash)
"Qi" = (/obj/structure/stone_tile,/turf/open/floor/plating/dirt/jungle/dark{planetary_atmos = 0; slowdown = 0},/area/heretic_sacrifice/ash)
"QL" = (/obj/effect/decal/cleanable/dirt,/obj/effect/decal/cleanable/blood/old,/turf/open/indestructible/necropolis/air,/area/heretic_sacrifice/flesh)
"Rb" = (/obj/effect/decal/cleanable/blood/old,/turf/open/floor/plating/asteroid,/area/heretic_sacrifice/void)
"Rh" = (/obj/effect/decal/cleanable/dirt,/obj/effect/turf_decal/trimline/brown/line,/turf/open/floor/plating/rust,/area/heretic_sacrifice/rust)
"RW" = (/obj/effect/decal/cleanable/dirt,/turf/open/indestructible/necropolis/air,/area/heretic_sacrifice/flesh)
"Se" = (/turf/open/floor/plating,/area/heretic_sacrifice/rust)
"St" = (/obj/effect/decal/cleanable/dirt,/turf/open/floor/stone,/area/heretic_sacrifice/flesh)
"Sy" = (/obj/structure/stone_tile/block{dir = 4},/turf/open/floor/plating/dirt/jungle/dark{planetary_atmos = 0; slowdown = 0},/area/heretic_sacrifice/ash)
"Tf" = (/obj/effect/landmark/heretic/flesh,/turf/open/indestructible/necropolis/air,/area/heretic_sacrifice/flesh)
"TC" = (/obj/effect/decal/remains/human,/turf/open/floor/plating/asteroid,/area/heretic_sacrifice/void)
"TS" = (/obj/effect/decal/cleanable/blood/old,/turf/open/floor/plating,/area/heretic_sacrifice/rust)
"Ue" = (/obj/machinery/light/very_dim/directional/west,/turf/open/floor/fakespace,/area/heretic_sacrifice/void)
"UO" = (/obj/effect/turf_decal/trimline/brown/corner{dir = 8},/turf/open/floor/plating/rust,/area/heretic_sacrifice/rust)
"VK" = (/obj/effect/decal/cleanable/ash{pixel_x = -8; pixel_y = 8},/obj/effect/decal/cleanable/dirt/dust,/turf/open/floor/plating/dirt/jungle/dark{planetary_atmos = 0; slowdown = 0},/area/heretic_sacrifice/ash)
"Wb" = (/obj/effect/decal/remains/human,/turf/open/floor/plating/dirt/jungle/dark{planetary_atmos = 0; slowdown = 0},/area/heretic_sacrifice/ash)
"WD" = (/turf/closed/indestructible/iron{opacity = 1},/area/heretic_sacrifice/rust)
"Xr" = (/turf/open/floor/plating/rust,/area/heretic_sacrifice/rust)
"Xt" = (/obj/machinery/light/very_dim/directional/north,/turf/open/floor/fakespace,/area/heretic_sacrifice/void)
"Zs" = (/obj/effect/landmark/heretic/rust,/turf/open/floor/plating/rust,/area/heretic_sacrifice/rust)
"ZA" = (/turf/closed/indestructible/riveted/boss,/area/heretic_sacrifice/ash)

(1,1,1) = {"
FdFdFdFdFdFdFdFdFdFdFdFdFdFdFdFdFdFdFdFdFdFdFdFdFdFdFd
FdZAZAZAZAZAZAZAZAZAZAZAZAFdWDWDWDWDWDWDWDWDWDWDWDWDFd
FdZAdXwSnGBwBwBwBwdXwSnGZAFdWDdZdZERSeXrSeXrpsANERWDFd
FdZAwSkAVKBwBwBwBwWbkAwSZAFdWDdZmRmbjgzUSeuuSemRCfWDFd
FdZAxiLAsbBwtHBwBwOGGICVZAFdWDdZJyHENhSeXrXrSeByERWDFd
FdZABwcdBwdXdEwEBwBwlzBwZAFdWDERJefhtFRhRhUOTSuuJeWDFd
FdZABwBwBwvvnPMfODBwnLzbZAFdWDANuufhuTZsquyCSejgXrWDFd
FdZABwBwGlvvIinPSyIepNNAZAFdWDfhfhgJuTZsquyCuuNhSeWDFd
FdZABwBwBwBwGIGINQlzPlBwZAFdWDXrXrTSAHCkmGptXrpsSeWDFd
FdZAdXQinGBwDLDLBwdXwCnGZAFdWDXrpsdZERXrSeXrpsERANWDFd
FdZAwSkAKzBwlzlzwtKukAwSZAFdWDXrmRCfpsSeNhXrCfmRERWDFd
FdZAxiKuCVBwlzBwBwxiwSCVZAFdWDXrXrERANSeXrJeERERXrWDFd
FdZAZAZAZAZAZAZAZAZAZAZAZAcHWDWDWDWDWDWDWDWDWDWDWDWDFd
FdFdFdFdFdFdFdFdFdFdFdFdFdFdFdFdFdFdFdFdFdFdFdFdFdFdFd
FdLaLaLaLaLaLaLaLaLaLaLaLaFdHQHQHQHQHQHQHQHQHQHQHQHQFd
FdLaAOAOwYAOAOXtAOwYohohLaFdHQcSvscScScScScSrvStcSHQFd
FdLaAOwYKPwYAOAOAOAOwYRbLaFdHQuiJAxVuiStStuiuiyyuiHQFd
FdLaAOAOwYAOAOAOAOAOAOwYLaFdHQcSStlbuicSRWuicSuilbHQFd
FdLaAOAOAOAOwYwYAOAOAOAOLaFdHQcSuiuitjuiuiuiuiuiRWHQFd
FdLaUeAOAOwYqMoCwYAOAOAOLaFdHQcSuicSStvZTfuicSStRWHQFd
FdLaAOAOAOwYqMqMwYAOAOabLaFdHQRWuicSStBvlBStcSuicSHQFd
FdLaAOAOAOAOwYwYAOAOAOwYLaFdHQRWStuiuiuiuiJJuiuicSHQFd
FdLaAOAOAOAOAOAOAOAOwYTCLaFdHQcSvsrvStcSlbuiQLStRWHQFd
FdLawYAOAOAOwYwYwYAOAOwYLaFdHQuiMZuiStStuiuiuiJAvsHQFd
FdLaohwYAOwYmZohohwYAOAOLaFdHQcSuicScScScScScSuicSHQFd
FdLaLaLaLaLaLaLaLaLaLaLaLaFdHQHQHQHQHQHQHQHQHQHQHQHQFd
FdFdFdFdFdFdFdFdFdFdFdFdFdFdFdFdFdFdFdFdFdFdFdFdFdFdFd
"}
