//MAP CONVERTED BY dmm2tgm.py THIS HEADER COMMENT PREVENTS RECONVERSION, DO NOT REMOVE
"aM" = (
/obj/structure/window/reinforced{
	dir = 1
	},
/obj/structure/window/reinforced{
	dir = 8
	},
/obj/machinery/atmospherics/pipe/smart/manifold4w/supply/hidden/layer4,
/obj/machinery/atmospherics/pipe/smart/manifold4w/scrubbers/hidden/layer2,
/turf/open/floor/iron,
/area/commons/baseball/view)
"aZ" = (
/obj/structure/cable,
/turf/closed/wall,
/area/commons/baseball/locker)
"bI" = (
/obj/structure/window/reinforced{
	dir = 8
	},
/obj/structure/table,
/obj/machinery/atmospherics/pipe/smart/manifold4w/scrubbers/hidden/layer2,
/obj/structure/cable,
/turf/open/floor/iron,
/area/commons/baseball)
"cJ" = (
/obj/machinery/atmospherics/components/unary/vent_scrubber/on/layer2,
/turf/open/floor/iron,
/area/commons/baseball/view)
"cU" = (
/obj/structure/window/reinforced/fulltile,
/obj/structure/grille,
/obj/machinery/atmospherics/pipe/smart/manifold4w/supply/hidden/layer4,
/obj/machinery/atmospherics/pipe/smart/manifold4w/scrubbers/hidden/layer2,
/obj/structure/cable,
/turf/open/floor/iron,
/area/commons/baseball)
"dY" = (
/obj/machinery/atmospherics/pipe/smart/manifold4w/supply/hidden/layer4,
/obj/machinery/atmospherics/pipe/smart/manifold4w/scrubbers/hidden/layer2,
/turf/open/floor/iron,
/area/commons/baseball/view)
"el" = (
/obj/machinery/atmospherics/pipe/smart/manifold4w/supply/hidden/layer4,
/obj/machinery/atmospherics/pipe/smart/manifold4w/scrubbers/hidden/layer2,
/turf/open/floor/iron,
/area/commons/baseball/locker)
"eQ" = (
/obj/machinery/atmospherics/components/unary/vent_scrubber/on/layer2{
	dir = 4
	},
/turf/open/floor/iron,
/area/commons/baseball/locker)
"fg" = (
/obj/structure/table,
/obj/machinery/chem_dispenser/drinks{
	dir = 8
	},
/turf/open/floor/iron,
/area/commons/baseball/view)
"fM" = (
/obj/structure/window/reinforced{
	dir = 8
	},
/obj/machinery/atmospherics/pipe/smart/manifold4w/supply/hidden/layer4,
/obj/machinery/atmospherics/pipe/smart/manifold4w/scrubbers/hidden/layer2,
/obj/machinery/light/directional/west,
/turf/open/floor/grass,
/area/commons/baseball)
"gd" = (
/obj/machinery/light/directional/south,
/turf/open/floor/plating/ironsand,
/area/commons/baseball)
"gh" = (
/obj/effect/turf_decal/trimline/white/line{
	dir = 4
	},
/turf/open/floor/plating/ironsand,
/area/commons/baseball)
"gj" = (
/obj/machinery/deepfryer,
/turf/open/floor/iron,
/area/commons/baseball/view)
"gl" = (
/obj/structure/table,
/obj/machinery/chem_dispenser/drinks/beer{
	dir = 8
	},
/turf/open/floor/iron,
/area/commons/baseball/view)
"gG" = (
/obj/structure/chair{
	dir = 8
	},
/obj/machinery/atmospherics/components/unary/vent_pump/on/layer4{
	dir = 8
	},
/obj/machinery/light/small/directional/north,
/turf/open/floor/iron,
/area/commons/baseball)
"gR" = (
/obj/structure/table,
/obj/item/reagent_containers/food/drinks/bottle/beer,
/turf/open/floor/iron,
/area/commons/baseball/view)
"hb" = (
/obj/structure/window/reinforced{
	dir = 1
	},
/obj/machinery/atmospherics/pipe/smart/manifold4w/supply/hidden/layer4,
/obj/machinery/atmospherics/pipe/smart/manifold4w/scrubbers/hidden/layer2,
/obj/machinery/light/directional/north,
/turf/open/floor/grass,
/area/commons/baseball)
"hu" = (
/obj/structure/railing,
/turf/open/floor/plating/grass,
/area/commons/baseball)
"hD" = (
/obj/item/clothing/under/shorts/red,
/obj/item/clothing/under/shorts/red,
/obj/item/clothing/under/shorts/red,
/obj/effect/turf_decal/tile/red/full,
/obj/machinery/light/small/directional/north,
/obj/structure/closet,
/turf/open/floor/iron,
/area/commons/baseball/locker)
"hJ" = (
/obj/machinery/light/small/directional/south,
/turf/open/floor/iron,
/area/commons/baseball/locker)
"if" = (
/obj/effect/turf_decal/trimline/green/filled/line{
	dir = 1
	},
/obj/machinery/airalarm/directional/east,
/turf/open/floor/iron,
/area/commons/baseball/view)
"im" = (
/obj/machinery/atmospherics/pipe/smart/manifold4w/supply/hidden/layer4,
/obj/machinery/atmospherics/pipe/smart/manifold4w/scrubbers/hidden/layer2,
/obj/structure/cable,
/obj/machinery/door/airlock,
/turf/open/floor/iron,
/area/commons/baseball/locker)
"jf" = (
/obj/effect/turf_decal/trimline/green/filled/corner{
	dir = 8
	},
/obj/machinery/atmospherics/pipe/smart/manifold4w/supply/hidden/layer4,
/obj/machinery/atmospherics/pipe/smart/manifold4w/scrubbers/hidden/layer2,
/turf/open/floor/iron,
/area/commons/baseball/view)
"jv" = (
/obj/machinery/atmospherics/pipe/smart/manifold4w/scrubbers/visible/layer2,
/obj/machinery/atmospherics/pipe/smart/manifold4w/supply/visible/layer4,
/obj/structure/cable,
/turf/open/floor/plating,
/area/commons/baseball/view)
"jE" = (
/obj/structure/table,
/obj/item/food/hotdog,
/turf/open/floor/iron,
/area/commons/baseball/view)
"jF" = (
/obj/structure/window/reinforced{
	dir = 8
	},
/turf/open/floor/iron,
/area/commons/baseball/view)
"jJ" = (
/obj/structure/window/reinforced{
	dir = 8
	},
/obj/structure/table,
/obj/effect/spawner/random/food_or_drink/donkpockets,
/turf/open/floor/iron,
/area/commons/baseball/view)
"ki" = (
/obj/effect/turf_decal/trimline/green/filled/line{
	dir = 1
	},
/obj/machinery/atmospherics/pipe/smart/manifold4w/supply/hidden/layer4,
/obj/machinery/atmospherics/pipe/smart/manifold4w/scrubbers/hidden/layer2,
/turf/open/floor/iron,
/area/commons/baseball/view)
"kE" = (
/obj/machinery/door/airlock,
/turf/open/floor/iron,
/area/commons/baseball/locker)
"kM" = (
/obj/machinery/door/window,
/turf/open/floor/iron,
/area/commons/baseball/view)
"ld" = (
/turf/open/floor/iron/white/smooth_large,
/area/commons/baseball)
"lj" = (
/obj/structure/window/reinforced{
	dir = 1
	},
/obj/effect/turf_decal/trimline/green/filled/line{
	dir = 4
	},
/obj/machinery/atmospherics/pipe/smart/manifold4w/supply/hidden/layer4,
/obj/machinery/atmospherics/pipe/smart/manifold4w/supply/hidden/layer4,
/obj/machinery/atmospherics/pipe/smart/manifold4w/scrubbers/hidden/layer2,
/turf/open/floor/iron,
/area/commons/baseball/view)
"ll" = (
/obj/structure/chair{
	dir = 1
	},
/turf/open/floor/iron,
/area/commons/baseball/view)
"lm" = (
/obj/structure/chair/sofa/bench{
	dir = 1
	},
/turf/open/floor/iron,
/area/commons/baseball/locker)
"lp" = (
/obj/machinery/atmospherics/components/unary/vent_pump/on/layer4{
	dir = 8
	},
/obj/machinery/airalarm/directional/east,
/turf/open/floor/iron,
/area/commons/baseball/locker)
"md" = (
/obj/structure/window/reinforced{
	dir = 8
	},
/obj/structure/chair{
	dir = 1
	},
/obj/machinery/atmospherics/pipe/smart/manifold4w/supply/hidden/layer4,
/obj/machinery/atmospherics/pipe/smart/manifold4w/scrubbers/hidden/layer2,
/turf/open/floor/iron,
/area/commons/baseball/view)
"ms" = (
/turf/open/floor/iron,
/area/commons/baseball/view)
"mJ" = (
/obj/item/melee/baseball_bat,
/turf/open/floor/iron/white/smooth_large,
/area/commons/baseball)
"nP" = (
/obj/machinery/atmospherics/pipe/smart/manifold4w/supply/hidden/layer4,
/obj/machinery/atmospherics/pipe/smart/manifold4w/scrubbers/hidden/layer2,
/obj/structure/cable,
/turf/open/floor/iron,
/area/commons/baseball/view)
"og" = (
/obj/effect/spawner/costume/referee,
/obj/effect/spawner/costume/referee,
/obj/structure/closet,
/turf/open/floor/iron/cafeteria,
/area/commons/baseball/locker)
"on" = (
/obj/machinery/light/directional/north,
/turf/open/floor/plating/grass,
/area/commons/baseball)
"ps" = (
/obj/structure/window/reinforced{
	dir = 8
	},
/obj/machinery/atmospherics/pipe/smart/manifold4w/supply/hidden/layer4,
/obj/machinery/atmospherics/pipe/smart/manifold4w/scrubbers/hidden/layer2,
/turf/open/floor/grass,
/area/commons/baseball)
"pG" = (
/obj/structure/window/reinforced{
	dir = 1
	},
/obj/machinery/atmospherics/pipe/smart/manifold4w/supply/hidden/layer4,
/obj/machinery/atmospherics/pipe/smart/manifold4w/scrubbers/hidden/layer2,
/turf/open/floor/grass,
/area/commons/baseball)
"pM" = (
/obj/structure/window/reinforced{
	dir = 8
	},
/obj/machinery/atmospherics/components/unary/vent_scrubber/on/layer2{
	dir = 4
	},
/turf/open/floor/iron,
/area/commons/baseball/view)
"qa" = (
/obj/machinery/door/window/westleft,
/obj/machinery/power/apc/auto_name/directional/south,
/obj/structure/cable,
/obj/structure/cable,
/turf/open/floor/iron,
/area/commons/baseball)
"qe" = (
/obj/effect/turf_decal/trimline/white/line{
	dir = 4
	},
/turf/open/floor/grass,
/area/commons/baseball)
"rb" = (
/obj/structure/chair{
	dir = 8
	},
/obj/machinery/atmospherics/components/unary/vent_scrubber/on/layer2{
	dir = 8
	},
/turf/open/floor/iron,
/area/commons/baseball)
"ro" = (
/obj/structure/railing{
	dir = 4
	},
/turf/open/floor/plating/ironsand,
/area/commons/baseball)
"ru" = (
/obj/structure/chair/sofa/bench/left{
	dir = 1
	},
/turf/open/floor/iron,
/area/commons/baseball/locker)
"rG" = (
/obj/machinery/door/airlock/external,
/obj/effect/mapping_helpers/airlock/cyclelink_helper{
	dir = 8
	},
/obj/machinery/atmospherics/pipe/smart/manifold4w/scrubbers/visible/layer2,
/obj/machinery/atmospherics/pipe/smart/manifold4w/supply/visible/layer4,
/obj/structure/cable,
/turf/open/floor/plating,
/area/commons/baseball/view)
"rJ" = (
/obj/structure/railing{
	dir = 4
	},
/turf/open/floor/plating/grass,
/area/commons/baseball)
"rK" = (
/obj/item/clothing/under/shorts/blue,
/obj/item/clothing/under/shorts/blue,
/obj/item/clothing/under/shorts/blue,
/obj/effect/turf_decal/tile/blue/full,
/obj/structure/cable,
/obj/structure/closet,
/turf/open/floor/iron,
/area/commons/baseball/locker)
"sC" = (
/obj/item/toy/beach_ball/baseball,
/turf/open/floor/iron/white/smooth_large,
/area/commons/baseball)
"uz" = (
/obj/effect/turf_decal/trimline/green/filled/line{
	dir = 8
	},
/obj/machinery/airalarm/directional/south,
/turf/open/floor/iron,
/area/commons/baseball/view)
"uS" = (
/obj/effect/spawner/costume/referee,
/obj/effect/spawner/costume/referee,
/obj/structure/closet,
/turf/open/floor/iron/cafeteria{
	dir = 8
	},
/area/commons/baseball/locker)
"vb" = (
/obj/structure/table,
/obj/machinery/light/directional/east,
/turf/open/floor/iron,
/area/commons/baseball/view)
"vf" = (
/turf/open/floor/plating/grass,
/area/commons/baseball)
"vp" = (
/obj/structure/chair/sofa/bench/right{
	dir = 1
	},
/turf/open/floor/iron,
/area/commons/baseball/locker)
"vz" = (
/obj/structure/railing{
	dir = 4
	},
/obj/machinery/atmospherics/components/unary/vent_pump/on/layer4{
	dir = 8
	},
/turf/open/floor/plating/grass,
/area/commons/baseball)
"vQ" = (
/obj/machinery/atmospherics/pipe/smart/manifold4w/supply/hidden/layer4,
/obj/machinery/atmospherics/pipe/smart/manifold4w/scrubbers/hidden/layer2,
/obj/machinery/power/apc/auto_name/directional/north,
/obj/structure/cable,
/turf/open/floor/iron,
/area/commons/baseball/locker)
"vW" = (
/obj/structure/chair/sofa/bench{
	dir = 1
	},
/obj/machinery/light/small/directional/south,
/turf/open/floor/iron,
/area/commons/baseball/locker)
"wV" = (
/obj/structure/window/reinforced{
	dir = 8
	},
/obj/structure/table,
/obj/item/phone,
/obj/machinery/atmospherics/pipe/smart/manifold4w/supply/hidden/layer4,
/obj/machinery/atmospherics/pipe/smart/manifold4w/scrubbers/hidden/layer2,
/obj/structure/cable,
/turf/open/floor/iron,
/area/commons/baseball)
"xc" = (
/obj/machinery/light/directional/east,
/turf/open/floor/plating/ironsand,
/area/commons/baseball)
"xt" = (
/obj/machinery/light/directional/south,
/turf/open/floor/iron/white/smooth_large,
/area/commons/baseball)
"xC" = (
/obj/effect/turf_decal/trimline/white/line,
/turf/open/floor/plating/ironsand,
/area/commons/baseball)
"xJ" = (
/obj/structure/railing,
/obj/machinery/atmospherics/components/unary/vent_scrubber/on/layer2{
	dir = 1
	},
/turf/open/floor/plating/ironsand,
/area/commons/baseball)
"yn" = (
/obj/machinery/atmospherics/components/unary/vent_pump/on/layer4{
	dir = 8
	},
/turf/open/floor/plating/grass,
/area/commons/baseball)
"yB" = (
/obj/structure/window/reinforced{
	dir = 8
	},
/obj/structure/chair{
	dir = 1
	},
/obj/structure/window/reinforced{
	dir = 1
	},
/obj/machinery/atmospherics/pipe/smart/manifold4w/supply/hidden/layer4,
/obj/machinery/atmospherics/pipe/smart/manifold4w/scrubbers/hidden/layer2,
/turf/open/floor/iron,
/area/commons/baseball/view)
"yU" = (
/obj/structure/window/reinforced{
	dir = 8
	},
/obj/structure/chair{
	dir = 8
	},
/obj/structure/window/reinforced,
/turf/open/floor/iron,
/area/commons/baseball/view)
"yW" = (
/turf/open/floor/plating/ironsand,
/area/commons/baseball)
"zn" = (
/obj/structure/cable,
/turf/open/floor/iron,
/area/commons/baseball/view)
"zp" = (
/obj/structure/window/reinforced{
	dir = 8
	},
/obj/structure/window/reinforced{
	dir = 1
	},
/obj/machinery/atmospherics/pipe/smart/manifold4w/supply/hidden/layer4,
/obj/machinery/atmospherics/pipe/smart/manifold4w/scrubbers/hidden/layer2,
/turf/open/floor/grass,
/area/commons/baseball)
"zu" = (
/obj/structure/window/reinforced{
	dir = 8
	},
/obj/structure/chair{
	dir = 8
	},
/turf/open/floor/iron,
/area/commons/baseball/view)
"zN" = (
/obj/machinery/door/airlock/external,
/obj/effect/mapping_helpers/airlock/cyclelink_helper{
	dir = 4
	},
/obj/machinery/atmospherics/pipe/smart/manifold4w/scrubbers/visible/layer2,
/obj/machinery/atmospherics/pipe/smart/manifold4w/supply/visible/layer4,
/obj/structure/cable,
/turf/open/floor/plating,
/area/commons/baseball/view)
"Af" = (
/obj/effect/turf_decal/trimline/green/filled/corner{
	dir = 4
	},
/obj/machinery/atmospherics/pipe/smart/manifold4w/supply/hidden/layer4,
/obj/machinery/atmospherics/pipe/smart/manifold4w/scrubbers/hidden/layer2,
/turf/open/floor/iron,
/area/commons/baseball/view)
"Ar" = (
/obj/machinery/light/directional/east,
/obj/structure/chair,
/turf/open/floor/iron,
/area/commons/baseball/view)
"AL" = (
/obj/structure/window/reinforced{
	dir = 1
	},
/obj/structure/chair{
	dir = 1
	},
/turf/open/floor/iron,
/area/commons/baseball/view)
"AZ" = (
/obj/structure/railing{
	dir = 4
	},
/obj/machinery/atmospherics/components/unary/vent_scrubber/on/layer2{
	dir = 8
	},
/turf/open/floor/plating/ironsand,
/area/commons/baseball)
"Bm" = (
/obj/effect/turf_decal/trimline/green/filled/line,
/obj/machinery/atmospherics/pipe/smart/manifold4w/supply/hidden/layer4,
/obj/machinery/atmospherics/pipe/smart/manifold4w/scrubbers/hidden/layer2,
/turf/open/floor/iron,
/area/commons/baseball/view)
"Cg" = (
/obj/effect/turf_decal/trimline/white/line,
/turf/open/floor/grass,
/area/commons/baseball)
"De" = (
/obj/machinery/atmospherics/pipe/smart/manifold4w/supply/hidden/layer4,
/obj/machinery/atmospherics/pipe/smart/manifold4w/scrubbers/hidden/layer2,
/obj/structure/cable,
/turf/open/floor/iron,
/area/commons/baseball/locker)
"EC" = (
/obj/structure/chair{
	dir = 8
	},
/turf/open/floor/iron,
/area/commons/baseball)
"FL" = (
/obj/structure/table,
/obj/effect/spawner/random/food_or_drink/refreshing_beverage,
/turf/open/floor/iron,
/area/commons/baseball/view)
"Gh" = (
/obj/machinery/door/airlock/external,
/obj/effect/mapping_helpers/airlock/cyclelink_helper,
/obj/machinery/atmospherics/pipe/smart/manifold4w/scrubbers/visible/layer2,
/obj/machinery/atmospherics/pipe/smart/manifold4w/supply/visible/layer4,
/obj/structure/cable,
/turf/open/floor/plating,
/area/commons/baseball/view)
"Gj" = (
/obj/structure/window/reinforced{
	dir = 1
	},
/obj/machinery/vending/boozeomat/all_access,
/turf/open/floor/iron,
/area/commons/baseball/view)
"Gl" = (
/obj/machinery/power/apc/auto_name/directional/south,
/obj/structure/cable,
/turf/open/floor/iron,
/area/commons/baseball/view)
"GB" = (
/obj/effect/turf_decal/trimline/white/line{
	dir = 4
	},
/obj/machinery/light/directional/east,
/turf/open/floor/plating/ironsand,
/area/commons/baseball)
"He" = (
/obj/effect/turf_decal/trimline/green/filled/line{
	dir = 1
	},
/turf/open/floor/iron,
/area/commons/baseball/view)
"Ia" = (
/obj/machinery/airalarm/directional/south,
/turf/open/floor/iron,
/area/commons/baseball)
"Il" = (
/obj/structure/railing,
/turf/open/floor/plating/ironsand,
/area/commons/baseball)
"Im" = (
/obj/machinery/light/directional/west,
/turf/open/floor/plating/grass,
/area/commons/baseball)
"Iy" = (
/obj/structure/chair{
	dir = 4
	},
/obj/structure/cable,
/turf/open/floor/iron,
/area/commons/baseball/view)
"IT" = (
/turf/open/floor/iron,
/area/commons/baseball)
"JF" = (
/turf/closed/wall,
/area/commons/baseball/locker)
"JS" = (
/obj/effect/turf_decal/trimline/white/line,
/obj/machinery/light/directional/south,
/turf/open/floor/plating/ironsand,
/area/commons/baseball)
"KM" = (
/obj/machinery/atmospherics/components/unary/vent_pump/on/layer4,
/turf/open/floor/iron,
/area/commons/baseball/view)
"KN" = (
/obj/item/clothing/under/shorts/red,
/obj/item/clothing/under/shorts/red,
/obj/item/clothing/under/shorts/red,
/obj/effect/turf_decal/tile/red/full,
/obj/structure/closet,
/turf/open/floor/iron,
/area/commons/baseball/locker)
"Mx" = (
/obj/structure/window/reinforced{
	dir = 8
	},
/obj/effect/turf_decal/trimline/white/line,
/obj/machinery/atmospherics/pipe/smart/manifold4w/supply/hidden/layer4,
/obj/machinery/atmospherics/pipe/smart/manifold4w/scrubbers/hidden/layer2,
/turf/open/floor/grass,
/area/commons/baseball)
"NW" = (
/obj/structure/table,
/obj/item/food/burger/baseball,
/turf/open/floor/iron,
/area/commons/baseball/view)
"Ok" = (
/turf/closed/wall,
/area/commons/baseball/view)
"OU" = (
/obj/machinery/light/small/directional/south,
/turf/open/floor/iron,
/area/commons/baseball)
"Ql" = (
/obj/machinery/atmospherics/pipe/smart/manifold4w/supply/hidden/layer4,
/obj/machinery/atmospherics/pipe/smart/manifold4w/scrubbers/hidden/layer2,
/obj/machinery/light/small/directional/north,
/obj/structure/cable,
/turf/open/floor/iron,
/area/commons/baseball/locker)
"Qu" = (
/obj/structure/railing,
/obj/machinery/atmospherics/components/unary/vent_pump/on/layer4{
	dir = 1
	},
/turf/open/floor/plating/grass,
/area/commons/baseball)
"QG" = (
/obj/structure/chair{
	dir = 4
	},
/turf/open/floor/iron,
/area/commons/baseball/view)
"QJ" = (
/obj/effect/turf_decal/trimline/green/filled/line{
	dir = 4
	},
/obj/structure/chair/stool/bar/directional/east,
/obj/machinery/atmospherics/pipe/smart/manifold4w/supply/hidden/layer4,
/obj/machinery/atmospherics/pipe/smart/manifold4w/scrubbers/hidden/layer2,
/turf/open/floor/iron,
/area/commons/baseball/view)
"RM" = (
/obj/structure/window/reinforced/fulltile,
/obj/structure/grille,
/turf/closed/wall,
/area/commons/baseball/view)
"Tb" = (
/obj/structure/window/reinforced{
	dir = 1
	},
/obj/structure/chair{
	dir = 1
	},
/obj/structure/chair{
	dir = 1
	},
/turf/open/floor/iron,
/area/commons/baseball/view)
"TC" = (
/obj/machinery/atmospherics/pipe/smart/manifold4w/supply/hidden/layer4,
/obj/machinery/atmospherics/pipe/smart/manifold4w/scrubbers/hidden/layer2,
/obj/machinery/light/directional/south,
/obj/structure/cable,
/turf/open/floor/iron,
/area/commons/baseball/view)
"TE" = (
/obj/structure/table,
/obj/machinery/microwave,
/turf/open/floor/iron,
/area/commons/baseball/view)
"TG" = (
/obj/structure/window/reinforced{
	dir = 8
	},
/obj/effect/turf_decal/trimline/green/filled/line,
/obj/machinery/atmospherics/pipe/smart/manifold4w/supply/hidden/layer4,
/obj/machinery/atmospherics/pipe/smart/manifold4w/scrubbers/hidden/layer2,
/turf/open/floor/iron,
/area/commons/baseball/view)
"TJ" = (
/obj/machinery/atmospherics/components/unary/vent_pump/on/layer4{
	dir = 4
	},
/turf/open/floor/iron,
/area/commons/baseball/view)
"TK" = (
/obj/structure/window/reinforced{
	dir = 1
	},
/obj/structure/chair{
	dir = 1
	},
/obj/structure/window/reinforced{
	dir = 4
	},
/turf/open/floor/iron,
/area/commons/baseball/view)
"UP" = (
/obj/structure/window/reinforced{
	dir = 1
	},
/obj/effect/turf_decal/trimline/white/line{
	dir = 4
	},
/obj/machinery/atmospherics/pipe/smart/manifold4w/supply/hidden/layer4,
/obj/machinery/atmospherics/pipe/smart/manifold4w/scrubbers/hidden/layer2,
/turf/open/floor/grass,
/area/commons/baseball)
"UR" = (
/obj/machinery/atmospherics/pipe/smart/manifold4w/supply/hidden/layer4,
/turf/open/floor/iron,
/area/commons/baseball/locker)
"US" = (
/obj/structure/window/reinforced{
	dir = 1
	},
/turf/open/floor/iron,
/area/commons/baseball/view)
"Wm" = (
/obj/machinery/light/directional/south,
/turf/open/floor/iron,
/area/commons/baseball/view)
"Xd" = (
/obj/structure/table,
/turf/open/floor/iron,
/area/commons/baseball/view)
"Xo" = (
/obj/machinery/door/airlock/external,
/obj/effect/mapping_helpers/airlock/cyclelink_helper{
	dir = 1
	},
/obj/machinery/atmospherics/pipe/smart/manifold4w/scrubbers/visible/layer2,
/obj/machinery/atmospherics/pipe/smart/manifold4w/supply/visible/layer4,
/obj/structure/cable,
/turf/open/floor/plating,
/area/commons/baseball/view)
"Yj" = (
/turf/closed/wall,
/area/commons/baseball)
"Ys" = (
/obj/structure/chair{
	dir = 8
	},
/turf/open/floor/iron,
/area/commons/baseball/view)
"YL" = (
/obj/effect/turf_decal/trimline/green/filled/line{
	dir = 8
	},
/turf/open/floor/iron,
/area/commons/baseball/view)
"Zp" = (
/obj/machinery/atmospherics/pipe/smart/manifold4w/supply/hidden/layer4,
/obj/machinery/atmospherics/pipe/smart/manifold4w/scrubbers/hidden/layer2,
/obj/machinery/power/apc/auto_name/directional/east,
/obj/structure/cable,
/turf/open/floor/iron,
/area/commons/baseball/view)
"Zu" = (
/obj/structure/window/reinforced{
	dir = 8
	},
/obj/machinery/light/directional/west,
/turf/open/floor/iron,
/area/commons/baseball/view)
"ZE" = (
/obj/machinery/light/directional/east,
/turf/open/floor/iron/white/smooth_large,
/area/commons/baseball)
"ZV" = (
/obj/machinery/door/window/eastleft,
/turf/open/floor/iron,
/area/commons/baseball/view)

(1,1,1) = {"
zp
ps
ps
ps
ps
ps
ps
ps
fM
ps
ps
ps
ps
Mx
yB
md
TG
Zu
jF
jJ
Ok
"}
(2,1,1) = {"
pG
yn
rJ
rJ
rJ
rJ
AZ
ro
ro
ro
ro
rJ
vz
Cg
Tb
ll
Bm
Xd
ms
TE
Ok
"}
(3,1,1) = {"
pG
hu
vf
yW
yW
yW
yW
yW
yW
yW
yW
yW
yW
Cg
US
cJ
Bm
Xd
ms
gj
Ok
"}
(4,1,1) = {"
pG
hu
yW
yW
xc
yW
yW
yW
yW
yW
yW
yW
yW
xC
AL
ll
Bm
Xd
ms
ms
Ok
"}
(5,1,1) = {"
pG
hu
yW
gd
ld
yW
yW
yW
yW
yW
yW
yW
yW
xt
AL
ll
Bm
Xd
ms
Wm
Ok
"}
(6,1,1) = {"
pG
hu
yW
yW
yW
yW
vf
vf
vf
vf
vf
vf
yW
xC
US
ms
Bm
NW
Xd
Xd
Ok
"}
(7,1,1) = {"
pG
Il
yW
yW
yW
vf
vf
vf
vf
vf
vf
vf
vf
xC
AL
ll
jf
YL
YL
uz
Ok
"}
(8,1,1) = {"
pG
xJ
yW
yW
yW
vf
vf
vf
yW
vf
vf
vf
vf
xC
AL
ll
nP
zn
Iy
Gl
Ok
"}
(9,1,1) = {"
hb
Il
yW
yW
yW
vf
vf
yW
sC
yW
vf
vf
vf
xC
US
KM
nP
Ar
gR
ll
Ok
"}
(10,1,1) = {"
pG
Il
yW
yW
yW
vf
vf
vf
yW
vf
vf
vf
vf
xC
AL
ms
TC
RM
Ok
Ok
Ok
"}
(11,1,1) = {"
pG
Il
yW
yW
yW
vf
vf
vf
vf
vf
vf
vf
vf
JS
TK
ZV
nP
nP
Gh
jv
Xo
"}
(12,1,1) = {"
pG
hu
yW
yW
yW
vf
vf
vf
vf
vf
vf
vf
vf
xC
Im
vf
JF
im
JF
JF
JF
"}
(13,1,1) = {"
pG
Qu
yW
yW
yW
yW
vf
vf
vf
vf
vf
vf
yW
xC
yW
vf
JF
vQ
uS
og
JF
"}
(14,1,1) = {"
UP
qe
qe
gh
ZE
gh
gh
gh
gh
gh
GB
gh
gh
mJ
yW
yW
JF
Ql
eQ
hJ
JF
"}
(15,1,1) = {"
aM
jF
pM
jF
jF
jF
jF
zu
zu
jF
yU
on
yW
yW
ld
yW
kE
De
el
ru
JF
"}
(16,1,1) = {"
lj
QJ
QJ
QJ
QJ
QJ
Af
Ys
Ys
TJ
kM
vf
vf
yW
yW
yW
JF
rK
UR
lm
JF
"}
(17,1,1) = {"
US
Xd
Xd
Xd
Xd
FL
ki
dY
dY
Zp
nP
cU
wV
bI
bI
qa
aZ
rK
UR
lm
JF
"}
(18,1,1) = {"
US
ms
ms
ms
ms
Xd
He
QG
ms
Ok
zN
Yj
gG
EC
rb
OU
JF
hD
UR
vW
JF
"}
(19,1,1) = {"
Gj
gl
fg
vb
ms
Xd
if
jE
ll
Ok
jv
Yj
IT
IT
IT
Ia
JF
KN
lp
vp
JF
"}
(20,1,1) = {"
Ok
Ok
Ok
Ok
Ok
Ok
Ok
Ok
Ok
Ok
rG
Yj
Yj
Yj
Yj
Yj
JF
JF
JF
JF
JF
"}
