//MAP CONVERTED BY dmm2tgm.py THIS HEADER COMMENT PREVENTS RECONVERSION, DO NOT REMOVE
"a" = (
/turf/open/floor/holofloor/plating,
/area/template_noop)
"c" = (
/obj/item/cardboard_cutout/adaptive{
	icon_state = "cutout_greytide";
	name = "White Pawn"
	},
/turf/open/floor/holofloor/dark,
/area/template_noop)
"d" = (
/turf/open/floor/holofloor/dark,
/area/template_noop)
"f" = (
/obj/effect/turf_decal/board_number/six{
	dir = 4
	},
/turf/open/floor/holofloor/plating,
/area/template_noop)
"g" = (
/obj/item/cardboard_cutout/adaptive{
	icon_state = "cutout_clown";
	name = "White King"
	},
/obj/item/cardboard_cutout/adaptive{
	icon_state = "cutout_clown";
	name = "White King"
	},
/obj/item/cardboard_cutout/adaptive{
	icon_state = "cutout_clown";
	name = "White King"
	},
/obj/item/cardboard_cutout/adaptive{
	icon_state = "cutout_clown";
	name = "White King"
	},
/obj/item/cardboard_cutout/adaptive{
	icon_state = "cutout_clown";
	name = "White King"
	},
/obj/effect/turf_decal/board_letter/h{
	dir = 1
	},
/turf/open/floor/holofloor/plating,
/area/template_noop)
"j" = (
/obj/effect/turf_decal/board_letter/a{
	dir = 1
	},
/turf/open/floor/holofloor/plating,
/area/template_noop)
"k" = (
/obj/effect/turf_decal/board_number/five{
	dir = 4
	},
/turf/open/floor/holofloor{
	icon_state = "white"
	},
/area/template_noop)
"l" = (
/obj/item/cardboard_cutout/adaptive{
	color = "#9999BB";
	icon_state = "cutout_greytide";
	name = "Black Pawn"
	},
/obj/effect/turf_decal/board_number/six{
	dir = 4
	},
/turf/open/floor/holofloor/dark,
/area/template_noop)
"o" = (
/obj/effect/turf_decal/board_number/three{
	dir = 4
	},
/turf/open/floor/holofloor/plating,
/area/template_noop)
"s" = (
/obj/effect/turf_decal/board_number/eight{
	dir = 4
	},
/turf/open/floor/holofloor/plating,
/area/template_noop)
"u" = (
/obj/effect/turf_decal/board_letter/d{
	dir = 1
	},
/turf/open/floor/holofloor/plating,
/area/template_noop)
"v" = (
/obj/effect/turf_decal/board_number/three{
	dir = 4
	},
/turf/open/floor/holofloor{
	icon_state = "white"
	},
/area/template_noop)
"x" = (
/obj/effect/turf_decal/board_letter/g{
	dir = 1
	},
/turf/open/floor/holofloor{
	icon_state = "white"
	},
/area/template_noop)
"y" = (
/obj/effect/turf_decal/board_number/four{
	dir = 4
	},
/turf/open/floor/holofloor/dark,
/area/template_noop)
"z" = (
/obj/item/cardboard_cutout/adaptive{
	color = "#9999BB";
	icon_state = "cutout_clown";
	name = "Black King"
	},
/obj/item/cardboard_cutout/adaptive{
	color = "#9999BB";
	icon_state = "cutout_clown";
	name = "Black King"
	},
/obj/item/cardboard_cutout/adaptive{
	color = "#9999BB";
	icon_state = "cutout_clown";
	name = "Black King"
	},
/obj/item/cardboard_cutout/adaptive{
	color = "#9999BB";
	icon_state = "cutout_clown";
	name = "Black King"
	},
/obj/item/cardboard_cutout/adaptive{
	color = "#9999BB";
	icon_state = "cutout_clown";
	name = "Black King"
	},
/turf/open/floor/holofloor/plating,
/area/template_noop)
"A" = (
/obj/effect/turf_decal/board_number/seven{
	dir = 4
	},
/turf/open/floor/holofloor/plating,
/area/template_noop)
"B" = (
/obj/effect/turf_decal/board_letter/e{
	dir = 1
	},
/turf/open/floor/holofloor/plating,
/area/template_noop)
"C" = (
/obj/effect/turf_decal/board_number/four{
	dir = 4
	},
/turf/open/floor/holofloor/plating,
/area/template_noop)
"E" = (
/obj/item/cardboard_cutout/adaptive{
	icon_state = "cutout_greytide";
	name = "White Pawn"
	},
/obj/effect/turf_decal/board_number/two{
	dir = 4
	},
/turf/open/floor/holofloor/dark,
/area/template_noop)
"G" = (
/obj/item/cardboard_cutout/adaptive{
	color = "#9999BB";
	icon_state = "cutout_greytide";
	name = "Black Pawn"
	},
/obj/effect/turf_decal/board_letter/f{
	dir = 1
	},
/turf/open/floor/holofloor/dark,
/area/template_noop)
"H" = (
/obj/effect/turf_decal/board_number/one{
	dir = 4
	},
/turf/open/floor/holofloor/plating,
/area/template_noop)
"I" = (
/obj/effect/turf_decal/board_letter/f{
	dir = 1
	},
/turf/open/floor/holofloor/plating,
/area/template_noop)
"J" = (
/turf/open/floor/holofloor{
	icon_state = "white"
	},
/area/template_noop)
"K" = (
/obj/item/cardboard_cutout/adaptive{
	color = "#9999BB";
	icon_state = "cutout_greytide";
	name = "Black Pawn"
	},
/obj/effect/turf_decal/board_letter/d{
	dir = 1
	},
/turf/open/floor/holofloor/dark,
/area/template_noop)
"L" = (
/obj/effect/turf_decal/board_letter/a{
	dir = 1
	},
/turf/open/floor/holofloor{
	icon_state = "white"
	},
/area/template_noop)
"M" = (
/obj/item/cardboard_cutout/adaptive{
	color = "#9999BB";
	icon_state = "cutout_greytide";
	name = "Black Pawn"
	},
/turf/open/floor/holofloor/dark,
/area/template_noop)
"N" = (
/obj/effect/turf_decal/board_letter/g{
	dir = 1
	},
/turf/open/floor/holofloor/plating,
/area/template_noop)
"O" = (
/obj/item/cardboard_cutout/adaptive{
	color = "#9999BB";
	icon_state = "cutout_greytide";
	name = "Black Pawn"
	},
/obj/effect/turf_decal/board_letter/h{
	dir = 1
	},
/obj/effect/turf_decal/board_number/eight{
	dir = 4
	},
/turf/open/floor/holofloor/dark,
/area/template_noop)
"P" = (
/obj/effect/turf_decal/board_number/two{
	dir = 4
	},
/turf/open/floor/holofloor/plating,
/area/template_noop)
"Q" = (
/obj/effect/turf_decal/board_letter/c{
	dir = 1
	},
/turf/open/floor/holofloor{
	icon_state = "white"
	},
/area/template_noop)
"R" = (
/obj/effect/turf_decal/board_number/one{
	dir = 4
	},
/turf/open/floor/holofloor{
	icon_state = "white"
	},
/area/template_noop)
"T" = (
/obj/effect/turf_decal/board_number/five{
	dir = 4
	},
/turf/open/floor/holofloor/plating,
/area/template_noop)
"V" = (
/obj/effect/turf_decal/board_letter/c{
	dir = 1
	},
/turf/open/floor/holofloor/plating,
/area/template_noop)
"W" = (
/obj/effect/turf_decal/board_letter/e{
	dir = 1
	},
/turf/open/floor/holofloor{
	icon_state = "white"
	},
/area/template_noop)
"X" = (
/obj/effect/turf_decal/board_letter/b{
	dir = 1
	},
/turf/open/floor/holofloor/plating,
/area/template_noop)
"Y" = (
/obj/item/cardboard_cutout/adaptive{
	color = "#9999BB";
	icon_state = "cutout_greytide";
	name = "Black Pawn"
	},
/obj/effect/turf_decal/board_letter/b{
	dir = 1
	},
/turf/open/floor/holofloor/dark,
/area/template_noop)
"Z" = (
/obj/effect/turf_decal/board_number/seven{
	dir = 4
	},
/turf/open/floor/holofloor{
	icon_state = "white"
	},
/area/template_noop)

(1,1,1) = {"
a
s
A
f
T
C
o
P
H
a
"}
(2,1,1) = {"
a
L
M
J
d
J
c
J
c
j
"}
(3,1,1) = {"
a
Y
J
M
J
d
J
c
J
X
"}
(4,1,1) = {"
a
Q
M
J
d
J
c
J
c
V
"}
(5,1,1) = {"
a
K
J
M
J
d
J
c
J
u
"}
(6,1,1) = {"
a
W
M
J
d
J
c
J
c
B
"}
(7,1,1) = {"
a
G
J
M
J
d
J
c
J
I
"}
(8,1,1) = {"
a
x
M
J
d
J
c
J
c
N
"}
(9,1,1) = {"
z
O
Z
l
k
y
v
E
R
g
"}
